SrcMac,DstMac,SrcAddr,Sport,DstAddr,Dport,Proto,Mean,TotPkts,SrcPkts,DstPkts,TotBytes,SrcBytes,DstBytes,Rate,State,Dur
00:23:ae:9b:ad:b3,00:c1:b1:14:eb:31,192.168.10.19,123,144.217.240.204,123,17,5.000090,3,2,1,270,180,90,0.399993,CON,5.000090
00:23:ae:9b:8a:bf,00:c1:b1:14:eb:31,192.168.10.16,57426,52.22.113.46,443,6,4.538044,5,3,2,1221,706,515,0.881437,sSE,4.538044
b8:ac:6f:1d:1f:6c,00:c1:b1:14:eb:31,192.168.10.9,1550,52.84.145.30,80,6,4.984923,5,3,2,306,180,126,0.802420,sSEfF,4.984923
b8:ac:6f:36:0a:8b,00:c1:b1:14:eb:31,192.168.10.5,49519,173.241.242.220,443,6,4.972541,20,8,12,12444,4166,8278,3.820984,sSE,4.972541
00:23:ae:9b:ad:b3,00:c1:b1:14:eb:31,192.168.10.19,123,129.128.12.20,123,17,4.093569,6,3,3,540,270,270,1.221428,CON,4.093569
b8:ac:6f:36:0a:8b,00:c1:b1:14:eb:31,192.168.10.5,49517,211.14.21.32,443,6,3.582064,44,17,27,39849,2345,37504,12.004252,sSE,3.582064
b8:ac:6f:1d:1f:6c,00:c1:b1:14:eb:31,192.168.10.9,1548,52.19.201.247,443,6,4.191518,8,4,4,536,265,271,1.670039,sSEfFR,4.191518
b8:ac:6f:1d:1f:6c,00:c1:b1:14:eb:31,192.168.10.9,1575,23.61.187.27,80,6,3.008092,6,3,3,366,180,186,1.662183,sSEfF,3.008092
b8:ac:6f:1d:1f:6c,00:c1:b1:14:eb:31,192.168.10.9,1574,23.61.187.27,80,6,4.916587,5,3,2,306,180,126,0.813573,sSEfF,4.916587
b8:ac:6f:36:07:ee,00:c1:b1:14:eb:31,192.168.10.14,51197,13.107.4.50,80,6,5.061082,18680,12564,6116,9994363,753840,9240523,3690.712891,sSE,5.061082
b8:ac:6f:36:0a:8b,00:c1:b1:14:eb:31,192.168.10.5,49545,211.14.21.32,443,6,2.644174,26,12,14,15013,2153,12860,9.454748,sSE,2.644174
b8:ac:6f:36:0a:8b,00:c1:b1:14:eb:31,192.168.10.5,49546,211.14.21.32,443,6,1.632945,22,10,12,13281,2033,11248,12.860201,sSE,1.632945
b8:ac:6f:36:0a:8b,00:c1:b1:14:eb:31,192.168.10.5,49547,211.14.21.32,443,6,2.898838,53,19,34,44832,2573,42259,17.938221,sSE,2.898838
b8:ac:6f:36:0a:8b,00:c1:b1:14:eb:31,192.168.10.5,49548,211.14.21.32,443,6,3.075921,36,15,21,26307,2333,23974,11.378706,sSE,3.075921
00:23:ae:9b:ad:b3,00:c1:b1:14:eb:31,192.168.10.19,123,69.165.222.176,123,17,4.035581,6,3,3,540,270,270,1.238979,CON,4.035581
b8:ac:6f:36:07:ee,00:c1:b1:14:eb:31,192.168.10.14,51064,23.217.22.161,443,6,0.189742,4,2,2,320,160,160,15.810944,sSE,0.189742
b8:ac:6f:36:07:ee,00:c1:b1:14:eb:31,192.168.10.14,51057,23.50.75.27,80,6,0.023021,2,1,1,126,60,66,43.438599,sSE,0.023021
b8:ac:6f:36:07:ee,00:c1:b1:14:eb:31,192.168.10.14,51056,104.97.121.67,443,6,0.023805,2,1,1,126,60,66,42.007980,sSE,0.023805
b8:ac:6f:1d:1f:6c,00:c1:b1:14:eb:31,192.168.10.9,1646,23.61.187.27,80,6,4.735474,5,3,2,306,180,126,0.844688,sSEfF,4.735474
00:23:ae:9b:95:67,00:c1:b1:14:eb:31,192.168.10.17,123,91.189.89.198,123,17,0.101146,2,1,1,180,90,90,9.886699,CON,0.101146
00:23:ae:9b:ad:b3,00:c1:b1:14:eb:31,192.168.10.19,123,206.108.0.133,123,17,4.022397,6,3,3,540,270,270,1.243040,CON,4.022397
00:23:ae:9b:ad:b3,00:c1:b1:14:eb:31,192.168.10.19,123,144.217.163.175,123,17,4.024358,6,3,3,540,270,270,1.242434,CON,4.024358
00:23:ae:9b:ad:b3,00:c1:b1:14:eb:31,192.168.10.19,123,144.217.240.204,123,17,3.999029,5,2,3,450,180,270,1.000243,CON,3.999029
b8:ac:6f:36:0a:8b,00:c1:b1:14:eb:31,192.168.10.5,49549,211.14.21.32,443,6,0.614863,13,6,7,5953,931,5022,19.516544,sSE,0.614863
b8:ac:6f:36:07:ee,00:c1:b1:14:eb:31,192.168.10.14,51201,172.217.11.2,80,6,0.036884,3,2,1,180,120,60,54.224056,sSEf,0.036884
b8:ac:6f:36:07:ee,00:c1:b1:14:eb:31,192.168.10.14,51202,172.217.11.2,80,6,0.036381,3,2,1,180,120,60,54.973751,sSEf,0.036381
00:23:ae:9b:8a:bf,18:66:da:9b:e3:7d,192.168.10.16,6741,192.168.10.3,53,17,0.103272,4,2,2,682,160,522,29.049501,CON,0.103272
00:23:ae:9b:8a:bf,18:66:da:9b:e3:7d,192.168.10.16,39021,192.168.10.3,53,17,0.149841,4,2,2,586,160,426,20.021223,CON,0.149841
18:66:da:9b:e3:7d,00:c1:b1:14:eb:31,192.168.10.3,61091,192.168.10.1,53,17,0.102537,2,1,1,349,101,248,9.752577,CON,0.102537
18:66:da:9b:e3:7d,00:c1:b1:14:eb:31,192.168.10.3,60349,192.168.10.1,53,17,0.148553,2,1,1,383,101,282,6.731604,CON,0.148553
b8:ac:6f:1d:1f:6c,00:c1:b1:14:eb:31,192.168.10.9,1526,52.84.143.148,80,6,0.022088,3,2,1,180,120,60,90.546898,sSEfF,0.022088
00:23:ae:9b:8a:bf,00:c1:b1:14:eb:31,192.168.10.16,59188,54.208.26.241,443,6,0.174970,15,8,7,6188,1229,4959,80.013718,sSE,0.174970
00:23:ae:9b:8a:bf,18:66:da:9b:e3:7d,192.168.10.16,50746,192.168.10.3,53,17,0.102228,4,2,2,682,160,522,29.346167,CON,0.102228
b8:ac:6f:36:0a:8b,18:66:da:9b:e3:7d,192.168.10.5,52059,192.168.10.3,53,17,0.179446,6,4,2,644,328,316,27.863537,CON,0.179446
18:66:da:9b:e3:7d,00:c1:b1:14:eb:31,192.168.10.3,61212,192.168.10.1,53,17,0.178974,2,1,1,262,93,169,5.587404,CON,0.178974
b8:ac:6f:36:0a:8b,18:66:da:9b:e3:7d,192.168.10.5,64094,192.168.10.3,53,17,0.056046,6,4,2,542,340,202,89.212433,CON,0.056046
18:66:da:9b:e3:7d,00:c1:b1:14:eb:31,192.168.10.3,61390,192.168.10.1,53,17,0.055580,2,1,1,208,96,112,17.992083,CON,0.055580
b8:ac:6f:36:0a:8b,00:c1:b1:14:eb:31,192.168.10.5,49550,210.160.193.189,443,6,1.957743,19,8,11,7321,1315,6006,9.194261,sSEfF,1.957743
b8:ac:6f:36:0a:8b,00:c1:b1:14:eb:31,192.168.10.5,49551,210.160.193.189,443,6,1.917082,19,8,11,7324,1315,6009,9.389270,sSEfF,1.917082
b8:ac:6f:36:07:ee,00:c1:b1:14:eb:31,192.168.10.14,51071,52.84.143.110,80,6,0.022009,2,1,1,126,60,66,45.435959,sSE,0.022009
18:66:da:9b:e3:7d,00:c1:b1:14:eb:31,192.168.10.3,61191,192.168.10.1,53,17,0.000470,2,1,1,352,135,217,2127.659668,CON,0.000470
00:1e:4f:d4:ca:28,18:66:da:9b:e3:7d,192.168.10.15,55002,192.168.10.3,53,17,0.000278,4,2,2,468,170,298,10791.367188,CON,0.000278
b8:ac:6f:36:0a:8b,00:c1:b1:14:eb:31,192.168.10.5,49552,72.21.81.64,443,6,2.908129,49,24,25,16277,3354,12923,16.505457,sSE,2.908129
00:23:ae:9b:8a:bf,18:66:da:9b:e3:7d,192.168.10.16,41358,192.168.10.3,53,17,0.048935,4,2,2,416,156,260,61.305813,CON,0.048935
00:23:ae:9b:8a:bf,18:66:da:9b:e3:7d,192.168.10.16,59485,192.168.10.3,53,17,0.068303,4,2,2,440,156,284,43.921940,CON,0.068303
18:66:da:9b:e3:7d,00:c1:b1:14:eb:31,192.168.10.3,61396,192.168.10.1,53,17,0.048333,2,1,1,230,89,141,20.689798,CON,0.048333
18:66:da:9b:e3:7d,00:c1:b1:14:eb:31,192.168.10.3,62021,192.168.10.1,53,17,0.067667,2,1,1,242,89,153,14.778253,CON,0.067667
00:23:ae:9b:8a:bf,00:c1:b1:14:eb:31,192.168.10.16,45930,93.184.215.245,443,6,0.163633,16,8,8,5051,1314,3737,91.668549,sSE,0.163633
00:23:ae:9b:8a:bf,18:66:da:9b:e3:7d,192.168.10.16,63140,192.168.10.3,53,17,0.047666,4,2,2,416,156,260,62.937946,CON,0.047666
00:23:ae:9b:8a:bf,18:66:da:9b:e3:7d,192.168.10.16,55598,192.168.10.3,53,17,0.304810,4,2,2,868,148,720,9.842197,CON,0.304810
00:23:ae:9b:8a:bf,18:66:da:9b:e3:7d,192.168.10.16,13505,192.168.10.3,53,17,0.352155,4,2,2,612,148,464,8.518976,CON,0.352155
18:66:da:9b:e3:7d,00:c1:b1:14:eb:31,192.168.10.3,62486,192.168.10.1,53,17,0.304188,2,1,1,456,85,371,3.287441,CON,0.304188
18:66:da:9b:e3:7d,00:c1:b1:14:eb:31,192.168.10.3,61850,192.168.10.1,53,17,0.350920,2,1,1,410,85,325,2.849653,CON,0.350920
b8:ac:6f:36:07:ee,00:c1:b1:14:eb:31,192.168.10.14,51074,23.50.75.27,80,6,0.029993,2,1,1,126,60,66,33.341114,sSE,0.029993
b8:ac:6f:36:07:ee,00:c1:b1:14:eb:31,192.168.10.14,51075,23.50.75.27,80,6,0.031302,2,1,1,126,60,66,31.946838,sSE,0.031302
b8:ac:6f:36:0a:8b,00:c1:b1:14:eb:31,192.168.10.5,49553,210.160.193.189,443,6,0.192594,3,2,1,192,126,66,10.384540,sSE,0.192594
b8:ac:6f:36:0a:8b,18:66:da:9b:e3:7d,192.168.10.5,51834,192.168.10.3,53,17,0.024045,4,2,2,324,146,178,124.766068,CON,0.024045
b8:ac:6f:36:0a:8b,18:66:da:9b:e3:7d,192.168.10.5,52191,192.168.10.3,53,17,0.070973,6,4,2,740,324,416,70.449326,CON,0.070973
b8:ac:6f:36:0a:8b,18:66:da:9b:e3:7d,192.168.10.5,65315,192.168.10.3,53,17,0.047449,6,4,2,534,288,246,105.376297,CON,0.047449
18:66:da:9b:e3:7d,00:c1:b1:14:eb:31,192.168.10.3,60498,192.168.10.1,53,17,0.023599,2,1,1,184,84,100,42.374676,CON,0.023599
18:66:da:9b:e3:7d,00:c1:b1:14:eb:31,192.168.10.3,62038,192.168.10.1,53,17,0.070584,2,1,1,271,109,162,14.167517,CON,0.070584
b8:ac:6f:36:0a:8b,18:66:da:9b:e3:7d,192.168.10.5,63183,192.168.10.3,53,17,0.000239,4,2,2,328,148,180,12552.300781,CON,0.000239
18:66:da:9b:e3:7d,00:c1:b1:14:eb:31,192.168.10.3,62007,192.168.10.1,53,17,0.046858,2,1,1,201,83,118,21.341072,CON,0.046858
b8:ac:6f:36:0a:8b,18:66:da:9b:e3:7d,192.168.10.5,57079,192.168.10.3,53,17,0.047305,6,4,2,638,304,334,105.697075,CON,0.047305
b8:ac:6f:36:0a:8b,00:c1:b1:14:eb:31,192.168.10.5,49554,74.217.253.61,443,6,0.146532,9,6,3,1120,682,438,54.595585,sSE,0.146532
18:66:da:9b:e3:7d,00:c1:b1:14:eb:31,192.168.10.3,60162,192.168.10.1,53,17,0.046903,2,1,1,265,87,178,21.320599,CON,0.046903
b8:ac:6f:36:0a:8b,00:c1:b1:14:eb:31,192.168.10.5,49555,74.217.253.61,443,6,0.146484,9,6,3,1120,682,438,54.613472,sSE,0.146484
b8:ac:6f:36:0a:8b,00:c1:b1:14:eb:31,192.168.10.5,49556,74.217.253.61,443,6,0.155965,9,6,3,1120,682,438,51.293560,sSE,0.155965
b8:ac:6f:36:0a:8b,00:c1:b1:14:eb:31,192.168.10.5,49557,68.67.178.184,443,6,0.152402,12,7,5,4207,741,3466,72.177528,sSE,0.152402
b8:ac:6f:36:0a:8b,00:c1:b1:14:eb:31,192.168.10.5,49558,68.67.178.184,443,6,0.162370,12,7,5,4207,741,3466,67.746506,sSE,0.162370
b8:ac:6f:36:0a:8b,00:c1:b1:14:eb:31,192.168.10.5,49559,68.67.178.184,443,6,0.172253,10,7,3,1179,741,438,52.248730,sSE,0.172253
b8:ac:6f:36:0a:8b,00:c1:b1:14:eb:31,192.168.10.5,49560,198.8.70.212,443,6,0.148647,11,6,5,3925,928,2997,67.273476,sSE,0.148647
b8:ac:6f:36:0a:8b,00:c1:b1:14:eb:31,192.168.10.5,49561,198.8.70.212,443,6,0.148603,11,6,5,3925,928,2997,67.293388,sSE,0.148603
b8:ac:6f:36:0a:8b,00:c1:b1:14:eb:31,192.168.10.5,49562,198.8.70.212,443,6,0.148548,11,6,5,3925,928,2997,67.318306,sSE,0.148548
b8:ac:6f:36:0a:8b,00:c1:b1:14:eb:31,192.168.10.5,49563,74.121.138.87,443,6,0.138412,11,6,5,4146,684,3462,72.248070,sSE,0.138412
b8:ac:6f:36:0a:8b,00:c1:b1:14:eb:31,192.168.10.5,49564,74.121.138.87,443,6,0.128439,11,6,5,4146,684,3462,77.857971,sSE,0.128439
b8:ac:6f:36:0a:8b,00:c1:b1:14:eb:31,192.168.10.5,49565,74.121.138.87,443,6,0.148267,11,6,5,4146,684,3462,67.445892,sSE,0.148267
00:23:ae:9b:8a:bf,00:c1:b1:14:eb:31,192.168.10.16,45990,104.97.120.69,443,6,0.023951,9,5,4,638,343,295,334.015289,sSEfFR,0.023951
b8:ac:6f:36:07:ee,00:c1:b1:14:eb:31,192.168.10.14,51135,104.244.55.19,443,6,0.029022,5,2,3,325,120,205,137.826477,sSEfF,0.029022
b8:ac:6f:36:0a:8b,00:c1:b1:14:eb:31,192.168.10.5,49566,159.127.41.169,443,6,0.331010,11,6,5,4163,689,3474,30.210566,sSE,0.331010
b8:ac:6f:36:0a:8b,00:c1:b1:14:eb:31,192.168.10.5,49567,159.127.41.169,443,6,0.330937,11,6,5,4163,689,3474,30.217232,sSE,0.330937
b8:ac:6f:36:0a:8b,00:c1:b1:14:eb:31,192.168.10.5,49568,159.127.41.169,443,6,0.330865,11,6,5,4163,689,3474,30.223808,sSE,0.330865
b8:ac:6f:1d:1f:6c,00:c1:b1:14:eb:31,192.168.10.9,1659,151.101.0.166,80,6,0.019930,2,1,1,126,60,66,50.175617,sSE,0.019930
b8:ac:6f:36:07:ee,00:c1:b1:14:eb:31,192.168.10.14,51076,23.50.75.27,80,6,1.593320,6,3,3,366,180,186,3.138102,sSEfF,1.593320
b8:ac:6f:36:07:ee,00:c1:b1:14:eb:31,192.168.10.14,51073,23.50.75.27,80,6,0.031276,2,1,1,126,60,66,31.973400,sSE,0.031276
18:66:da:9b:e3:7d,00:c1:b1:14:eb:31,192.168.10.3,62303,192.168.10.1,53,17,0.000403,2,1,1,344,131,213,2481.389404,CON,0.000403
b8:ac:6f:1d:1f:6c,00:c1:b1:14:eb:31,192.168.10.9,1651,8.43.72.21,80,6,0.034666,2,1,1,126,60,66,28.846706,sSE,0.034666
b8:ac:6f:1d:1f:6c,00:c1:b1:14:eb:31,192.168.10.9,1662,23.2.12.111,80,6,0.032873,2,1,1,126,60,66,30.420101,sSE,0.032873
b8:ac:6f:1d:1f:6c,00:c1:b1:14:eb:31,192.168.10.9,1667,152.163.56.2,80,6,0.028352,2,1,1,120,60,60,35.270882,sSE,0.028352
00:23:ae:9b:ad:b3,00:c1:b1:14:eb:31,192.168.10.19,123,206.108.0.132,123,17,4.029068,6,3,3,540,270,270,1.240982,CON,4.029068
b8:ac:6f:1d:1f:6c,00:c1:b1:14:eb:31,192.168.10.9,1674,23.15.4.17,80,6,0.014995,2,1,1,126,60,66,66.688896,sSE,0.014995
b8:ac:6f:1d:1f:6c,00:c1:b1:14:eb:31,192.168.10.9,1675,104.88.69.146,80,6,0.029918,2,1,1,126,60,66,33.424694,sSE,0.029918
b8:ac:6f:36:0a:8b,18:66:da:9b:e3:7d,192.168.10.5,49387,192.168.10.3,53,17,0.073449,6,4,2,646,336,310,68.074448,CON,0.073449
18:66:da:9b:e3:7d,00:c1:b1:14:eb:31,192.168.10.3,61324,192.168.10.1,53,17,0.072999,2,1,1,261,95,166,13.698817,CON,0.072999
b8:ac:6f:36:0a:8b,18:66:da:9b:e3:7d,192.168.10.5,58688,192.168.10.3,53,17,0.095881,6,4,2,672,352,320,52.147976,CON,0.095881
18:66:da:9b:e3:7d,00:c1:b1:14:eb:31,192.168.10.3,61999,192.168.10.1,53,17,0.095553,2,1,1,270,99,171,10.465396,CON,0.095553
b8:ac:6f:1d:1f:6c,00:c1:b1:14:eb:31,192.168.10.9,1686,69.169.86.38,80,6,5.030271,6,3,3,360,180,180,0.993982,sSEfF,5.030271
b8:ac:6f:1d:1f:6c,00:c1:b1:14:eb:31,192.168.10.9,1544,23.61.187.27,80,6,0.044860,3,2,1,180,120,60,44.583145,sSEfF,0.044860
b8:ac:6f:1d:1f:6c,00:c1:b1:14:eb:31,192.168.10.9,1540,23.194.181.63,443,6,0.032948,6,3,3,410,205,205,151.754288,sSEfR,0.032948
b8:ac:6f:1d:1f:6c,00:c1:b1:14:eb:31,192.168.10.9,1541,52.84.143.226,80,6,0.022021,3,2,1,180,120,60,90.822403,sSEfF,0.022021
b8:ac:6f:1d:1f:6c,00:c1:b1:14:eb:31,192.168.10.9,1534,172.217.11.40,80,6,0.044469,3,2,1,180,120,60,44.975151,sSEfF,0.044469
b8:ac:6f:1d:1f:6c,00:c1:b1:14:eb:31,192.168.10.9,1689,74.121.138.156,80,6,0.024962,2,1,1,126,60,66,40.060890,sSE,0.024962
b8:ac:6f:36:0a:8b,18:66:da:9b:e3:7d,192.168.10.5,54305,192.168.10.3,53,17,3.032017,8,8,0,688,688,0,2.308694,INT,3.032017
b8:ac:6f:36:0a:8b,18:66:da:9b:e3:7d,192.168.10.5,60060,192.168.10.3,53,17,0.001540,4,2,2,448,170,278,1948.052002,CON,0.001540
b8:ac:6f:36:0a:8b,18:66:da:9b:e3:7d,192.168.10.5,55868,192.168.10.3,53,17,0.025467,4,2,2,466,172,294,117.799500,CON,0.025467
18:66:da:9b:e3:7d,00:c1:b1:14:eb:31,192.168.10.3,61762,192.168.10.1,53,17,0.202300,2,1,1,194,97,97,4.943154,CON,0.202300
18:66:da:9b:e3:7d,00:c1:b1:14:eb:31,192.168.10.3,60254,192.168.10.1,53,17,0.025085,2,1,1,255,97,158,39.864460,CON,0.025085
18:66:da:9b:e3:7d,00:c1:b1:14:eb:31,192.168.10.3,61624,192.168.10.1,53,17,0.000998,2,1,1,246,96,150,1002.003967,CON,0.000998
b8:ac:6f:36:0a:8b,18:66:da:9b:e3:7d,192.168.10.5,60009,192.168.10.3,53,17,0.000174,4,2,2,390,172,218,17241.378906,CON,0.000174
b8:ac:6f:36:07:ee,00:c1:b1:14:eb:31,192.168.10.14,51143,104.244.55.20,443,6,0.030106,5,2,3,325,120,205,132.863876,sSEfF,0.030106
b8:ac:6f:36:0a:8b,00:c1:b1:14:eb:31,192.168.10.5,52774,172.217.11.2,443,17,0.726748,5,3,2,1286,1001,285,5.503971,CON,0.726748
b8:ac:6f:36:0a:8b,00:c1:b1:14:eb:31,192.168.10.5,57254,216.58.219.228,443,17,0.057648,6,3,3,734,472,262,86.733276,CON,0.057648
b8:ac:6f:36:0a:8b,00:c1:b1:14:eb:31,192.168.10.5,49523,23.192.61.7,443,6,0.075694,3,2,1,737,470,267,26.422173,sSE,0.075694
b8:ac:6f:36:0a:8b,18:66:da:9b:e3:7d,192.168.10.5,58833,192.168.10.3,53,17,0.210859,6,4,2,642,296,346,23.712528,CON,0.210859
18:66:da:9b:e3:7d,00:c1:b1:14:eb:31,192.168.10.3,61464,192.168.10.1,53,17,0.210594,2,1,1,269,85,184,4.748473,CON,0.210594
b8:ac:6f:1d:1f:6c,00:c1:b1:14:eb:31,192.168.10.9,1660,198.54.12.127,80,6,4.886953,6,3,3,360,180,180,1.023132,sSEfF,4.886953
b8:ac:6f:1d:1f:6c,00:c1:b1:14:eb:31,192.168.10.9,1692,69.169.85.7,80,6,4.850314,6,3,3,360,180,180,1.030861,sSEfF,4.850314
b8:ac:6f:1d:1f:6c,00:c1:b1:14:eb:31,192.168.10.9,1691,72.21.91.29,80,6,4.840501,5,3,2,306,180,126,0.826361,sSEfF,4.840501
00:23:ae:9b:8a:bf,00:c1:b1:14:eb:31,192.168.10.16,57426,52.22.113.46,443,6,0.054491,3,2,1,1150,701,449,36.703308,sSE,0.054491
b8:ac:6f:1d:1f:6c,00:c1:b1:14:eb:31,192.168.10.9,1688,74.121.138.156,80,6,0.026236,2,1,1,126,60,66,38.115566,sSE,0.026236
b8:ac:6f:1d:1f:6c,00:c1:b1:14:eb:31,192.168.10.9,1684,74.121.138.156,443,6,0.026237,2,1,1,126,60,66,38.114113,sSE,0.026237
b8:ac:6f:36:0a:8b,00:c1:b1:14:eb:31,192.168.10.5,49569,54.65.28.17,443,6,0.822204,20,13,7,2309,1536,773,23.108620,sSE,0.822204
00:23:ae:9b:8a:bf,00:c1:b1:14:eb:31,192.168.10.16,36258,23.23.170.207,443,6,0.053993,2,1,1,132,66,66,18.520918,sSE,0.053993
00:23:ae:9b:8a:bf,00:c1:b1:14:eb:31,192.168.10.16,34014,216.200.232.114,443,6,0.037212,2,1,1,132,66,66,26.873053,sSE,0.037212
b8:ac:6f:36:0a:8b,00:c1:b1:14:eb:31,192.168.10.5,49570,54.65.28.17,443,6,0.191866,3,2,1,192,126,66,10.423942,sSE,0.191866
00:23:ae:9b:95:67,00:c1:b1:14:eb:31,192.168.10.17,123,69.10.161.7,123,17,0.105391,2,1,1,180,90,90,9.488476,CON,0.105391
00:23:ae:9b:95:67,00:c1:b1:14:eb:31,192.168.10.17,123,69.195.159.158,123,17,0.048499,2,1,1,180,90,90,20.618982,CON,0.048499
b8:ac:6f:1d:1f:6c,00:c1:b1:14:eb:31,192.168.10.9,1649,172.217.10.226,80,6,0.040727,2,1,1,126,60,66,24.553736,sSE,0.040727
70:6e:6d:1d:bb:0f,01:00:0c:cc:cc:cc,01:00:0c:cc:cc:cc,170,70:6e:6d:1d:bb:0f,170,0,0.000000,1,1,0,458,458,0,0.000000,INT,0.000000
00:23:ae:9b:ad:b3,18:66:da:9b:e3:7d,192.168.10.19,123,192.168.10.3,123,17,0.000150,4,2,2,360,180,180,20000.000000,CON,0.000150
b8:ac:6f:36:0a:8b,00:c1:b1:14:eb:31,192.168.10.5,49526,65.55.252.71,80,6,0.000000,1,1,0,62,62,0,0.000000,s,0.000000
b8:ac:6f:1d:1f:6c,00:c1:b1:14:eb:31,192.168.10.9,1666,185.86.139.19,80,6,4.358788,6,3,3,360,180,180,1.147108,sSEfF,4.358788
b8:ac:6f:36:0a:8b,18:66:da:9b:e3:7d,192.168.10.5,63939,192.168.10.3,53,17,0.053352,6,4,2,640,348,292,93.717201,CON,0.053352
18:66:da:9b:e3:7d,00:c1:b1:14:eb:31,192.168.10.3,60536,192.168.10.1,53,17,0.052825,2,1,1,255,98,157,18.930431,CON,0.052825
b8:ac:6f:36:0a:8b,18:66:da:9b:e3:7d,192.168.10.5,52639,192.168.10.3,53,17,0.066508,6,4,2,636,336,300,75.178925,CON,0.066508
18:66:da:9b:e3:7d,00:c1:b1:14:eb:31,192.168.10.3,62069,192.168.10.1,53,17,0.066207,2,1,1,256,95,161,15.104143,CON,0.066207
b8:ac:6f:36:07:ee,00:c1:b1:14:eb:31,192.168.10.14,51141,74.119.118.84,443,6,0.027920,2,1,1,120,60,60,35.816620,sSE,0.027920
b8:ac:6f:36:07:ee,00:c1:b1:14:eb:31,192.168.10.14,50203,216.200.232.61,443,6,0.039115,2,1,1,126,60,66,25.565639,E,0.039115
b8:ac:6f:36:07:ee,00:c1:b1:14:eb:31,192.168.10.14,51086,23.111.9.32,443,6,0.089837,3,2,1,260,160,100,22.262543,sSE,0.089837
b8:ac:6f:36:07:ee,00:c1:b1:14:eb:31,192.168.10.14,51147,52.6.24.26,443,6,0.056067,2,1,1,126,60,66,17.835804,sSE,0.056067
18:66:da:9b:e3:7d,00:c1:b1:14:eb:31,192.168.10.3,62200,192.168.10.1,53,17,0.058544,2,1,1,281,98,183,17.081171,CON,0.058544
b8:ac:6f:36:08:f5,18:66:da:9b:e3:7d,192.168.10.8,49471,192.168.10.3,53,17,0.058444,4,2,2,518,174,344,51.331188,CON,0.058444
b8:ac:6f:36:0a:8b,00:c1:b1:14:eb:31,192.168.10.5,50286,172.217.11.2,443,17,1.457932,13,8,5,2208,939,1269,8.230837,CON,1.457932
b8:ac:6f:36:0a:8b,18:66:da:9b:e3:7d,192.168.10.5,64420,192.168.10.3,53,17,0.000181,4,2,2,416,170,246,16574.585938,CON,0.000181
b8:ac:6f:36:0a:8b,18:66:da:9b:e3:7d,192.168.10.5,63080,192.168.10.3,53,17,0.132738,6,4,2,682,312,370,37.668190,CON,0.132738
18:66:da:9b:e3:7d,00:c1:b1:14:eb:31,192.168.10.3,60338,192.168.10.1,53,17,0.132443,2,1,1,285,89,196,7.550418,CON,0.132443
b8:ac:6f:36:0a:8b,18:66:da:9b:e3:7d,192.168.10.5,63454,192.168.10.3,53,17,0.029283,4,2,2,536,168,368,102.448517,CON,0.029283
18:66:da:9b:e3:7d,00:c1:b1:14:eb:31,192.168.10.3,60727,192.168.10.1,53,17,0.028675,2,1,1,204,94,110,34.873585,CON,0.028675
b8:ac:6f:36:0a:8b,18:66:da:9b:e3:7d,192.168.10.5,63339,192.168.10.3,53,17,0.197928,6,4,2,750,360,390,25.261711,CON,0.197928
18:66:da:9b:e3:7d,00:c1:b1:14:eb:31,192.168.10.3,60416,192.168.10.1,53,17,0.197759,2,1,1,307,101,206,5.056660,CON,0.197759
b8:ac:6f:36:0a:8b,00:c1:b1:14:eb:31,192.168.10.5,49571,69.172.216.55,443,6,1.216077,35,25,10,11940,2342,9598,27.958757,sSEfF,1.216077
b8:ac:6f:1d:1f:6c,00:c1:b1:14:eb:31,192.168.10.9,1563,52.84.145.230,443,6,0.028312,5,3,2,325,205,120,141.282852,sSEfF,0.028312
b8:ac:6f:1d:1f:6c,00:c1:b1:14:eb:31,192.168.10.9,1561,52.84.145.235,80,6,0.028115,3,2,1,180,120,60,71.136406,sSEfF,0.028115
b8:ac:6f:36:0a:8b,00:c1:b1:14:eb:31,192.168.10.5,49572,23.12.36.193,443,6,0.992876,14,8,6,4055,2879,1176,13.093277,sSE,0.992876
b8:ac:6f:36:07:ee,00:c1:b1:14:eb:31,192.168.10.14,51151,74.119.118.67,443,6,0.028902,2,1,1,120,60,60,34.599682,sSE,0.028902
b8:ac:6f:36:08:f5,ff:ff:ff:ff:ff:ff,192.168.10.8,,192.168.10.1,,2054,0.000336,27,26,1,1620,1560,60,77380.953125,CON,0.000336
b8:ac:6f:36:08:f5,18:66:da:9b:e3:7d,192.168.10.8,51056,192.168.10.3,53,17,0.000135,4,2,2,428,166,262,22222.222656,CON,0.000135
b8:ac:6f:36:08:f5,18:66:da:9b:e3:7d,192.168.10.8,53240,192.168.10.3,53,17,0.029754,4,2,2,502,166,336,100.826782,CON,0.029754
18:66:da:9b:e3:7d,00:c1:b1:14:eb:31,192.168.10.3,62286,192.168.10.1,53,17,0.029368,2,1,1,273,94,179,34.050667,CON,0.029368
b8:ac:6f:36:08:f5,00:c1:b1:14:eb:31,192.168.10.8,49273,34.209.201.65,443,6,0.354292,10,7,3,1789,1558,231,25.402775,sSE,0.354292
b8:ac:6f:36:0a:8b,18:66:da:9b:e3:7d,192.168.10.5,51972,192.168.10.3,53,17,0.125620,6,4,2,586,288,298,39.802582,CON,0.125620
18:66:da:9b:e3:7d,00:c1:b1:14:eb:31,192.168.10.3,60975,192.168.10.1,53,17,0.125106,2,1,1,243,83,160,7.993221,CON,0.125106
b8:ac:6f:36:0a:8b,18:66:da:9b:e3:7d,192.168.10.5,57496,192.168.10.3,53,17,0.031181,6,4,2,594,328,266,160.354065,CON,0.031181
18:66:da:9b:e3:7d,00:c1:b1:14:eb:31,192.168.10.3,62412,192.168.10.1,53,17,0.030730,2,1,1,237,93,144,32.541492,CON,0.030730
b8:ac:6f:36:0a:8b,18:66:da:9b:e3:7d,192.168.10.5,55473,192.168.10.3,53,17,0.000188,4,2,2,364,166,198,15957.446289,CON,0.000188
b8:ac:6f:36:0a:8b,00:c1:b1:14:eb:31,192.168.10.5,49573,210.160.193.167,443,6,1.268518,17,9,8,4985,1565,3420,12.613144,sSEfF,1.268518
b8:ac:6f:36:0a:8b,00:c1:b1:14:eb:31,192.168.10.5,49574,210.160.193.167,443,6,1.268495,17,9,8,4985,1565,3420,12.613373,sSEfF,1.268495
b8:ac:6f:36:0a:8b,00:c1:b1:14:eb:31,192.168.10.5,49575,52.84.141.115,443,6,1.481092,34,23,11,15729,5198,10531,22.280857,sSE,1.481092
b8:ac:6f:36:0a:8b,00:c1:b1:14:eb:31,192.168.10.5,49576,104.106.249.194,443,6,1.412279,43,26,17,22552,2372,20180,29.739166,sSE,1.412279
b8:ac:6f:36:0a:8b,00:c1:b1:14:eb:31,192.168.10.5,49577,104.106.249.194,443,6,1.728970,28,17,11,11888,1832,10056,15.616234,sSE,1.728970
b8:ac:6f:36:0a:8b,00:c1:b1:14:eb:31,192.168.10.5,49578,157.240.18.5,443,6,0.906360,24,15,9,4188,2973,1215,25.376230,sSE,0.906360
00:c1:b1:14:eb:31,00:23:ae:9b:8a:bf,191.237.24.89,443,192.168.10.16,34436,6,0.000070,2,1,1,185,119,66,14285.713867,E,0.000070
b8:ac:6f:36:08:f5,18:66:da:9b:e3:7d,192.168.10.8,65241,192.168.10.3,53,17,0.000240,4,2,2,344,156,188,12500.000000,CON,0.000240
b8:ac:6f:36:08:f5,00:c1:b1:14:eb:31,192.168.10.8,49274,72.21.91.29,80,6,0.770166,12,7,5,4389,1713,2676,14.282636,sSE,0.770166
b8:ac:6f:1d:1f:6c,00:c1:b1:14:eb:31,192.168.10.9,1679,50.57.31.206,80,6,4.807386,6,3,3,360,180,180,1.040066,sSEfF,4.807386
b8:ac:6f:36:07:ee,00:c1:b1:14:eb:31,192.168.10.14,51157,152.163.56.2,443,6,0.033859,2,1,1,120,60,60,29.534245,sSE,0.033859
b8:ac:6f:36:07:ee,00:c1:b1:14:eb:31,192.168.10.14,51044,104.16.127.228,443,6,4.623910,7,4,3,451,265,186,1.297603,sSEfF,4.623910
b8:ac:6f:36:07:ee,00:c1:b1:14:eb:31,192.168.10.14,51145,23.60.72.143,443,6,0.083970,2,1,1,126,60,66,11.909015,sSE,0.083970
b8:ac:6f:36:08:f5,18:66:da:9b:e3:7d,192.168.10.8,64908,192.168.10.3,53,17,0.060923,4,2,2,492,188,304,49.242489,CON,0.060923
18:66:da:9b:e3:7d,00:c1:b1:14:eb:31,192.168.10.3,61234,192.168.10.1,53,17,0.060484,2,1,1,268,105,163,16.533298,CON,0.060484
b8:ac:6f:36:08:f5,00:c1:b1:14:eb:31,192.168.10.8,49275,52.33.61.7,443,6,0.675018,16,8,8,6095,1698,4397,22.221630,sSE,0.675018
b8:ac:6f:36:08:f5,18:66:da:9b:e3:7d,192.168.10.8,53076,192.168.10.3,53,17,0.000174,4,2,2,384,176,208,17241.378906,CON,0.000174
b8:ac:6f:36:08:f5,00:c1:b1:14:eb:31,192.168.10.8,49276,52.33.61.7,443,6,0.976668,15,9,6,6633,2710,3923,14.334452,sSE,0.976668
b8:ac:6f:36:08:f5,00:c1:b1:14:eb:31,192.168.10.8,49277,52.33.61.7,443,6,0.359847,11,7,4,2738,1638,1100,27.789587,sSE,0.359847
b8:ac:6f:36:08:f5,00:c1:b1:14:eb:31,192.168.10.8,49278,52.33.61.7,443,6,0.359848,14,7,7,5997,1660,4337,36.126366,sSE,0.359848
b8:ac:6f:36:08:f5,00:c1:b1:14:eb:31,192.168.10.8,49279,52.33.61.7,443,6,0.348657,11,7,4,2740,1640,1100,28.681482,sSE,0.348657
b8:ac:6f:36:08:f5,18:66:da:9b:e3:7d,192.168.10.8,63501,192.168.10.3,53,17,0.000811,4,2,2,522,176,346,3699.136963,CON,0.000811
18:66:da:9b:e3:7d,00:c1:b1:14:eb:31,192.168.10.3,61051,192.168.10.1,53,17,0.000459,2,1,1,283,99,184,2178.649170,CON,0.000459
b8:ac:6f:36:07:ee,00:c1:b1:14:eb:31,192.168.10.14,51162,8.43.72.98,443,6,0.042108,2,1,1,126,60,66,23.748457,sSE,0.042108
b8:ac:6f:36:07:ee,00:c1:b1:14:eb:31,192.168.10.14,51156,23.60.72.143,443,6,0.083850,2,1,1,126,60,66,11.926059,sSE,0.083850
b8:ac:6f:1d:1f:6c,00:c1:b1:14:eb:31,192.168.10.9,1536,52.84.145.83,443,6,0.229670,3,2,1,260,160,100,8.708146,sSE,0.229670
b8:ac:6f:1d:1f:6c,00:c1:b1:14:eb:31,192.168.10.9,1530,52.84.145.30,443,6,0.229664,3,2,1,260,160,100,8.708374,sSE,0.229664
b8:ac:6f:36:08:f5,00:c1:b1:14:eb:31,192.168.10.8,49280,52.33.61.7,443,6,0.479781,9,6,3,920,695,225,16.674274,sSE,0.479781
b8:ac:6f:36:07:ee,00:c1:b1:14:eb:31,192.168.10.14,51163,52.86.68.110,443,6,0.057785,2,1,1,120,60,60,17.305529,sSE,0.057785
b8:ac:6f:36:07:ee,00:c1:b1:14:eb:31,192.168.10.14,50849,23.36.34.44,443,6,0.035800,2,1,1,126,60,66,27.932962,sSE,0.035800
b8:ac:6f:36:07:ee,00:c1:b1:14:eb:31,192.168.10.14,51166,152.163.56.2,443,6,0.035793,2,1,1,120,60,60,27.938425,sSE,0.035793
b8:ac:6f:36:07:ee,00:c1:b1:14:eb:31,192.168.10.14,51165,52.73.61.178,443,6,0.060212,2,1,1,120,60,60,16.607985,sSE,0.060212
00:23:ae:9b:ad:b3,00:c1:b1:14:eb:31,192.168.10.19,123,206.75.89.101,123,17,4.094620,6,3,3,540,270,270,1.221115,CON,4.094620
00:23:ae:9b:ad:b3,00:c1:b1:14:eb:31,192.168.10.19,123,129.128.12.20,123,17,4.094575,6,3,3,540,270,270,1.221128,CON,4.094575
b8:ac:6f:36:07:ee,00:c1:b1:14:eb:31,192.168.10.14,51146,185.86.139.58,443,6,0.120916,2,1,1,120,60,60,8.270204,sSE,0.120916
b8:ac:6f:1d:1f:6c,00:c1:b1:14:eb:31,192.168.10.9,1701,207.200.74.133,80,6,4.363343,5,3,2,300,180,120,0.916728,sSEfF,4.363343
b8:ac:6f:36:08:f5,00:c1:b1:14:eb:31,192.168.10.8,49281,72.21.91.29,80,6,0.257690,7,4,3,1651,675,976,23.283789,sSE,0.257690
b8:ac:6f:36:08:f5,00:c1:b1:14:eb:31,192.168.10.8,49282,72.21.91.29,80,6,0.032667,3,2,1,192,126,66,61.223866,sSE,0.032667
b8:ac:6f:36:08:f5,00:c1:b1:14:eb:31,192.168.10.8,49283,72.21.91.29,80,6,0.257604,7,4,3,1651,675,976,23.291563,sSE,0.257604
70:6e:6d:1d:bb:04,01:00:0c:cc:cc:cc,01:00:0c:cc:cc:cc,170,70:6e:6d:1d:bb:04,170,0,0.000000,1,1,0,457,457,0,0.000000,INT,0.000000
b8:ac:6f:36:08:f5,00:c1:b1:14:eb:31,192.168.10.8,49284,72.21.91.29,80,6,0.032229,3,2,1,192,126,66,62.055916,sSE,0.032229
b8:ac:6f:36:07:ee,00:c1:b1:14:eb:31,192.168.10.14,51168,34.224.224.222,443,6,0.059071,2,1,1,126,60,66,16.928780,sSE,0.059071
b8:ac:6f:36:08:f5,00:c1:b1:14:eb:31,192.168.10.8,49285,72.21.91.29,80,6,0.031694,3,2,1,192,126,66,63.103428,sSE,0.031694
b8:ac:6f:36:0a:8b,00:c1:b1:14:eb:31,192.168.10.5,49519,173.241.242.220,443,6,0.151726,3,2,1,1224,1164,60,13.181657,sSE,0.151726
b8:ac:6f:36:0a:8b,00:c1:b1:14:eb:31,192.168.10.5,49579,173.241.242.220,443,6,4.012091,20,9,11,10684,2969,7715,4.735685,sSE,4.012091
b8:ac:6f:36:0a:8b,18:66:da:9b:e3:7d,192.168.10.5,56322,192.168.10.3,53,17,0.001467,4,2,2,472,172,300,2044.989746,CON,0.001467
18:66:da:9b:e3:7d,00:c1:b1:14:eb:31,192.168.10.3,60235,192.168.10.1,53,17,0.000975,2,1,1,258,97,161,1025.641113,CON,0.000975
b8:ac:6f:1d:1f:6c,00:c1:b1:14:eb:31,192.168.10.9,1608,50.16.197.102,80,6,0.059420,2,1,1,120,60,60,16.829350,sSE,0.059420
b8:ac:6f:36:0a:8b,18:66:da:9b:e3:7d,192.168.10.5,59703,192.168.10.3,53,17,0.049724,6,4,2,630,344,286,100.555061,CON,0.049724
18:66:da:9b:e3:7d,00:c1:b1:14:eb:31,192.168.10.3,61651,192.168.10.1,53,17,0.049245,2,1,1,251,97,154,20.306631,CON,0.049245
b8:ac:6f:36:0a:8b,18:66:da:9b:e3:7d,192.168.10.5,52587,192.168.10.3,53,17,0.086959,6,4,2,662,352,310,57.498363,CON,0.086959
18:66:da:9b:e3:7d,00:c1:b1:14:eb:31,192.168.10.3,61217,192.168.10.1,53,17,0.086621,2,1,1,265,99,166,11.544544,CON,0.086621
b8:ac:6f:36:0a:8b,18:66:da:9b:e3:7d,192.168.10.5,63448,192.168.10.3,53,17,0.057724,6,4,2,608,340,268,86.619087,CON,0.057724
18:66:da:9b:e3:7d,00:c1:b1:14:eb:31,192.168.10.3,61779,192.168.10.1,53,17,0.057554,2,1,1,241,96,145,17.374987,CON,0.057554
b8:ac:6f:36:0a:8b,18:66:da:9b:e3:7d,192.168.10.5,51583,192.168.10.3,53,17,0.088432,6,4,2,672,352,320,56.540619,CON,0.088432
18:66:da:9b:e3:7d,00:c1:b1:14:eb:31,192.168.10.3,61427,192.168.10.1,53,17,0.088053,2,1,1,270,99,171,11.356796,CON,0.088053
b8:ac:6f:36:07:ee,00:c1:b1:14:eb:31,192.168.10.14,51169,54.85.32.27,443,6,0.059057,2,1,1,120,60,60,16.932793,sSE,0.059057
b8:ac:6f:36:0a:8b,18:66:da:9b:e3:7d,192.168.10.5,50749,192.168.10.3,53,17,0.168514,6,4,2,586,312,274,29.671125,CON,0.168514
18:66:da:9b:e3:7d,00:c1:b1:14:eb:31,192.168.10.3,61860,192.168.10.1,53,17,0.168228,2,1,1,237,89,148,5.944314,CON,0.168228
b8:ac:6f:36:07:ee,00:c1:b1:14:eb:31,192.168.10.14,51154,104.196.189.120,443,6,0.061884,2,1,1,126,60,66,16.159266,sSE,0.061884
b8:ac:6f:36:07:ee,00:c1:b1:14:eb:31,192.168.10.14,51171,34.203.149.184,443,6,0.058836,2,1,1,126,60,66,16.996397,sSE,0.058836
b8:ac:6f:36:07:ee,00:c1:b1:14:eb:31,192.168.10.14,51170,54.85.32.27,443,6,0.058828,2,1,1,120,60,60,16.998709,sSE,0.058828
b8:ac:6f:1d:1f:6c,00:c1:b1:14:eb:31,192.168.10.9,1601,151.101.0.249,80,6,0.023484,3,2,1,180,120,60,85.164368,sSEfF,0.023484
b8:ac:6f:36:0a:8b,18:66:da:9b:e3:7d,192.168.10.5,53243,192.168.10.3,53,17,0.064377,6,4,2,1248,332,916,77.667488,CON,0.064377
18:66:da:9b:e3:7d,00:c1:b1:14:eb:31,192.168.10.3,61475,192.168.10.1,53,17,0.063810,2,1,1,521,89,432,15.671525,CON,0.063810
b8:ac:6f:36:0a:8b,18:66:da:9b:e3:7d,192.168.10.5,58560,192.168.10.3,53,17,0.033816,6,4,2,630,292,338,147.859009,CON,0.033816
18:66:da:9b:e3:7d,00:c1:b1:14:eb:31,192.168.10.3,60120,192.168.10.1,53,17,0.033522,2,1,1,204,94,110,29.831158,CON,0.033522
b8:ac:6f:36:0a:8b,00:c1:b1:14:eb:31,192.168.10.5,49580,52.84.140.227,443,6,0.120341,11,7,4,2323,1114,1209,83.097198,sSE,0.120341
b8:ac:6f:36:07:ee,00:c1:b1:14:eb:31,192.168.10.14,51172,54.85.32.27,443,6,0.060716,2,1,1,126,60,66,16.470123,sSE,0.060716
b8:ac:6f:36:0a:8b,00:c1:b1:14:eb:31,192.168.10.5,49581,23.36.34.44,443,6,0.163540,30,18,12,15316,2820,12496,177.326645,sSE,0.163540
