SrcMac,DstMac,SrcAddr,Sport,DstAddr,Dport,Proto,Mean,TotPkts,SrcPkts,DstPkts,TotBytes,SrcBytes,DstBytes,Rate,State,Dur
b8:ac:6f:36:07:ee,00:c1:b1:14:eb:31,192.168.10.14,50546,199.16.156.232,443,6,4.540814,11,6,5,830,465,365,2.202248,sSEfFR,4.540814
b8:ac:6f:36:07:ee,00:c1:b1:14:eb:31,192.168.10.14,50554,199.59.150.44,443,6,4.585245,12,6,6,890,465,425,2.398999,sSEfFR,4.585245
b8:ac:6f:36:07:ee,00:c1:b1:14:eb:31,192.168.10.14,50536,172.217.6.198,443,6,4.533690,10,6,4,745,465,280,1.985138,sSEfF,4.533690
b8:ac:6f:36:07:ee,00:c1:b1:14:eb:31,192.168.10.14,50545,31.13.80.36,443,6,4.519492,11,5,6,891,386,505,2.212638,sSEfF,4.519492
b8:ac:6f:36:0b:a8,00:c1:b1:14:eb:31,192.168.10.51,44956,151.101.210.2,443,6,4.796223,8,5,3,578,349,229,1.459482,sSEfFR,4.796223
b8:ac:6f:36:0b:a8,00:c1:b1:14:eb:31,192.168.10.51,57629,172.217.6.238,443,6,4.777200,7,4,3,493,295,198,1.255966,sSEfF,4.777200
b8:ac:6f:36:0b:a8,00:c1:b1:14:eb:31,192.168.10.51,47320,54.192.37.237,443,6,4.770614,6,4,2,427,295,132,1.048083,sSEfF,4.770614
b8:ac:6f:36:0b:a8,00:c1:b1:14:eb:31,192.168.10.51,40648,72.21.81.48,443,6,4.735069,12,7,5,770,445,325,2.323092,sSEfFR,4.735069
b8:ac:6f:36:0b:a8,00:c1:b1:14:eb:31,192.168.10.51,40651,72.21.81.48,443,6,4.635949,8,5,3,530,325,205,1.509939,sSEfFR,4.635949
b8:ac:6f:1d:1f:6c,00:c1:b1:14:eb:31,192.168.10.9,1495,206.19.49.186,80,6,4.764832,6,3,3,360,180,180,1.049355,sSEfF,4.764832
b8:ac:6f:36:07:ee,00:c1:b1:14:eb:31,192.168.10.14,50652,104.97.94.187,443,6,4.511313,98,52,46,57093,4516,52577,21.501501,sSE,4.511313
b8:ac:6f:36:08:f5,18:66:da:9b:e3:7d,192.168.10.8,54957,192.168.10.3,53,17,4.659640,10,6,4,1004,456,548,1.931480,CON,4.659640
b8:ac:6f:36:07:ee,00:c1:b1:14:eb:31,192.168.10.14,50569,172.217.11.2,443,6,4.826386,5,3,2,420,260,160,0.828777,sSE,4.826386
b8:ac:6f:36:0b:a8,00:c1:b1:14:eb:31,192.168.10.51,51050,173.222.140.253,443,6,4.861630,8,5,3,578,349,229,1.439846,sSEfR,4.861630
b8:ac:6f:36:07:ee,00:c1:b1:14:eb:31,192.168.10.14,50576,172.217.10.36,443,6,4.020736,10,6,4,745,465,280,2.238396,sSEfF,4.020736
b8:ac:6f:36:07:ee,00:c1:b1:14:eb:31,192.168.10.14,50531,152.195.33.25,443,6,4.737874,9,6,3,710,465,245,1.688521,sSEfFR,4.737874
b8:ac:6f:36:07:ee,00:c1:b1:14:eb:31,192.168.10.14,50544,172.217.6.198,443,6,4.021892,10,6,4,745,465,280,2.237753,sSEfF,4.021892
b8:ac:6f:36:07:ee,00:c1:b1:14:eb:31,192.168.10.14,50553,107.178.244.119,443,6,4.038119,10,6,4,745,465,280,2.228760,sSEfF,4.038119
b8:ac:6f:36:07:ee,00:c1:b1:14:eb:31,192.168.10.14,50508,66.235.155.61,443,6,4.044674,11,6,5,830,465,365,2.472387,sSEfFR,4.044674
b8:ac:6f:36:07:ee,00:c1:b1:14:eb:31,192.168.10.14,50584,172.217.1.163,443,6,4.760055,10,6,4,745,465,280,1.890734,sSEfF,4.760055
00:23:ae:9b:95:67,00:c1:b1:14:eb:31,192.168.10.17,43753,202.77.129.146,443,6,4.999586,6,3,3,407,180,227,1.000083,sSEfF,4.999586
b8:ac:6f:36:07:ee,00:c1:b1:14:eb:31,192.168.10.14,50502,172.217.12.142,443,6,3.773105,10,6,4,745,465,280,2.385303,sSEfF,3.773105
b8:ac:6f:36:07:ee,00:c1:b1:14:eb:31,192.168.10.14,50567,172.217.11.2,443,6,4.758196,10,6,4,745,465,280,1.891473,sSEfF,4.758196
b8:ac:6f:36:07:ee,00:c1:b1:14:eb:31,192.168.10.14,50673,93.184.216.180,443,6,3.444917,55,26,29,29057,2388,26669,15.675269,sSE,3.444917
b8:ac:6f:36:07:ee,33:33:00:01:00:02,fe80::3c60:fc97:3f94:ac8f,546,ff02::1:2,547,17,3.001155,78,78,0,12870,12870,0,25.656790,INT,3.001155
b8:ac:6f:36:07:ee,00:c1:b1:14:eb:31,192.168.10.14,50704,52.218.17.3,443,6,2.352079,151,74,77,103209,5543,97666,63.773369,sSE,2.352079
b8:ac:6f:36:07:ee,00:c1:b1:14:eb:31,192.168.10.14,50426,172.217.11.14,443,6,3.738830,10,6,4,745,465,280,2.407170,sSEfF,3.738830
b8:ac:6f:36:07:ee,00:c1:b1:14:eb:31,192.168.10.14,50711,162.248.16.34,443,6,0.590373,28,12,16,15439,2593,12846,45.733799,sSEfF,0.590373
b8:ac:6f:36:07:ee,00:c1:b1:14:eb:31,192.168.10.14,50712,162.248.16.34,443,6,0.393449,14,7,7,5891,934,4957,33.041130,sSE,0.393449
b8:ac:6f:36:07:ee,18:66:da:9b:e3:7d,192.168.10.14,58900,192.168.10.3,53,17,0.146992,4,2,2,758,180,578,20.409275,CON,0.146992
18:66:da:9b:e3:7d,00:c1:b1:14:eb:31,192.168.10.3,61267,192.168.10.1,53,17,0.146576,2,1,1,401,101,300,6.822399,CON,0.146576
b8:ac:6f:36:07:ee,18:66:da:9b:e3:7d,192.168.10.14,57732,192.168.10.3,53,17,0.069731,4,2,2,644,144,500,43.022472,CON,0.069731
18:66:da:9b:e3:7d,00:c1:b1:14:eb:31,192.168.10.3,61516,192.168.10.1,53,17,0.069430,2,1,1,344,83,261,14.402996,CON,0.069430
b8:ac:6f:36:07:ee,18:66:da:9b:e3:7d,192.168.10.14,63787,192.168.10.3,53,17,0.136317,4,2,2,658,158,500,22.007526,CON,0.136317
18:66:da:9b:e3:7d,00:c1:b1:14:eb:31,192.168.10.3,62100,192.168.10.1,53,17,0.135709,2,1,1,351,90,261,7.368708,CON,0.135709
70:6e:6d:1d:bb:0d,01:00:0c:cc:cc:cc,01:00:0c:cc:cc:cc,170,70:6e:6d:1d:bb:0d,170,0,0.000000,1,1,0,458,458,0,0.000000,INT,0.000000
b8:ac:6f:36:07:ee,18:66:da:9b:e3:7d,192.168.10.14,53077,192.168.10.3,53,17,0.060684,4,2,2,478,168,310,49.436424,CON,0.060684
18:66:da:9b:e3:7d,00:c1:b1:14:eb:31,192.168.10.3,62532,192.168.10.1,53,17,0.060248,2,1,1,261,95,166,16.598063,CON,0.060248
b8:ac:6f:36:07:ee,00:c1:b1:14:eb:31,192.168.10.14,50713,151.101.0.175,443,6,3.074235,102,39,63,94774,3342,91432,32.853703,sSE,3.074235
b8:ac:6f:36:07:ee,00:c1:b1:14:eb:31,192.168.10.14,50714,151.101.0.175,443,6,0.203082,11,7,4,3732,729,3003,49.241196,sSE,0.203082
b8:ac:6f:36:08:f5,18:66:da:9b:e3:7d,192.168.10.8,50781,192.168.10.3,53,17,0.000194,4,2,2,404,154,250,15463.917969,CON,0.000194
b8:ac:6f:36:08:f5,00:c1:b1:14:eb:31,192.168.10.8,49272,72.21.91.29,80,6,0.334742,9,5,4,2588,762,1826,23.899002,sSE,0.334742
b8:ac:6f:36:07:ee,00:c1:b1:14:eb:31,192.168.10.14,50715,52.214.25.111,443,6,0.452238,13,7,6,5236,747,4489,26.534700,sSE,0.452238
b8:ac:6f:36:07:ee,00:c1:b1:14:eb:31,192.168.10.14,50716,52.214.25.111,443,6,0.581150,15,8,7,6893,1869,5024,24.090166,sSE,0.581150
b8:ac:6f:36:07:ee,18:66:da:9b:e3:7d,192.168.10.14,63056,192.168.10.3,53,17,0.000233,4,2,2,540,206,334,12875.536133,CON,0.000233
b8:ac:6f:36:07:ee,00:c1:b1:14:eb:31,192.168.10.14,50717,52.84.145.242,443,6,0.180197,12,7,5,4186,736,3450,61.044300,sSE,0.180197
b8:ac:6f:36:07:ee,00:c1:b1:14:eb:31,192.168.10.14,50718,52.84.145.242,443,6,0.101026,13,7,6,5057,1041,4016,118.781303,sSE,0.101026
b8:ac:6f:36:07:ee,18:66:da:9b:e3:7d,192.168.10.14,55659,192.168.10.3,53,17,0.048696,4,2,2,448,170,278,61.606701,CON,0.048696
18:66:da:9b:e3:7d,00:c1:b1:14:eb:31,192.168.10.3,60784,192.168.10.1,53,17,0.048354,2,1,1,246,96,150,20.680813,CON,0.048354
b8:ac:6f:36:07:ee,18:66:da:9b:e3:7d,192.168.10.14,63650,192.168.10.3,53,17,0.024063,4,2,2,412,172,240,124.672729,CON,0.024063
18:66:da:9b:e3:7d,00:c1:b1:14:eb:31,192.168.10.3,60539,192.168.10.1,53,17,0.023708,2,1,1,228,97,131,42.179855,CON,0.023708
b8:ac:6f:36:07:ee,18:66:da:9b:e3:7d,192.168.10.14,53633,192.168.10.3,53,17,0.063878,4,2,2,480,174,306,46.964527,CON,0.063878
18:66:da:9b:e3:7d,00:c1:b1:14:eb:31,192.168.10.3,60396,192.168.10.1,53,17,0.063529,2,1,1,262,98,164,15.740843,CON,0.063529
b8:ac:6f:36:07:ee,18:66:da:9b:e3:7d,192.168.10.14,62095,192.168.10.3,53,17,0.024290,4,2,2,534,206,328,123.507622,CON,0.024290
b8:ac:6f:36:07:ee,18:66:da:9b:e3:7d,192.168.10.14,64026,192.168.10.3,53,17,0.000208,4,2,2,584,260,324,14423.077148,CON,0.000208
18:66:da:9b:e3:7d,00:c1:b1:14:eb:31,192.168.10.3,60601,192.168.10.1,53,17,0.023889,2,1,1,289,114,175,41.860271,CON,0.023889
b8:ac:6f:36:07:ee,18:66:da:9b:e3:7d,192.168.10.14,53958,192.168.10.3,53,17,0.000188,4,2,2,612,178,434,15957.446289,CON,0.000188
b8:ac:6f:36:07:ee,18:66:da:9b:e3:7d,192.168.10.14,52021,192.168.10.3,53,17,0.077398,4,2,2,684,260,424,38.760689,CON,0.077398
18:66:da:9b:e3:7d,00:c1:b1:14:eb:31,192.168.10.3,60920,192.168.10.1,53,17,0.077001,2,1,1,364,141,223,12.986845,CON,0.077001
b8:ac:6f:36:07:ee,18:66:da:9b:e3:7d,192.168.10.14,62180,192.168.10.3,53,17,0.067345,4,2,2,526,178,348,44.546738,CON,0.067345
18:66:da:9b:e3:7d,00:c1:b1:14:eb:31,192.168.10.3,61363,192.168.10.1,53,17,0.066899,2,1,1,285,100,185,14.947906,CON,0.066899
b8:ac:6f:36:07:ee,18:66:da:9b:e3:7d,192.168.10.14,57061,192.168.10.3,53,17,0.001020,4,2,2,526,216,310,2941.176514,CON,0.001020
18:66:da:9b:e3:7d,00:c1:b1:14:eb:31,192.168.10.3,62075,192.168.10.1,53,17,0.000597,2,1,1,218,101,117,1675.041870,CON,0.000597
b8:ac:6f:36:07:ee,18:66:da:9b:e3:7d,192.168.10.14,51682,192.168.10.3,53,17,0.000181,4,2,2,526,216,310,16574.585938,CON,0.000181
b8:ac:6f:36:07:ee,18:66:da:9b:e3:7d,192.168.10.14,58523,192.168.10.3,53,17,0.000158,4,2,2,392,180,212,18987.341797,CON,0.000158
b8:ac:6f:36:07:ee,18:66:da:9b:e3:7d,192.168.10.14,65345,192.168.10.3,53,17,0.000201,4,2,2,340,154,186,14925.373047,CON,0.000201
b8:ac:6f:36:07:ee,00:c1:b1:14:eb:31,192.168.10.14,50719,178.255.83.1,80,6,0.089351,10,5,5,1890,730,1160,100.726349,sSEfF,0.089351
b8:ac:6f:36:07:ee,00:c1:b1:14:eb:31,192.168.10.14,50720,178.255.83.1,80,6,0.108503,10,5,5,1890,730,1160,82.947014,sSEfF,0.108503
b8:ac:6f:36:07:ee,18:66:da:9b:e3:7d,192.168.10.14,59697,192.168.10.3,53,17,0.000204,4,2,2,340,154,186,14705.882812,CON,0.000204
b8:ac:6f:36:07:ee,00:c1:b1:14:eb:31,192.168.10.14,50721,178.255.83.1,80,6,2.203481,12,6,6,2022,796,1226,4.992101,sSEfF,2.203481
b8:ac:6f:36:07:ee,18:66:da:9b:e3:7d,192.168.10.14,59465,192.168.10.3,53,17,0.124415,8,4,4,728,308,420,56.263309,CON,0.124415
18:66:da:9b:e3:7d,00:c1:b1:14:eb:31,192.168.10.3,62289,192.168.10.1,53,17,0.023699,2,1,1,204,88,116,42.195873,CON,0.023699
b8:ac:6f:36:07:ee,18:66:da:9b:e3:7d,192.168.10.14,54212,192.168.10.3,53,17,0.023819,4,2,2,308,138,170,125.949875,CON,0.023819
18:66:da:9b:e3:7d,00:c1:b1:14:eb:31,192.168.10.3,60202,192.168.10.1,53,17,0.023353,2,1,1,176,80,96,42.821053,CON,0.023353
b8:ac:6f:36:07:ee,18:66:da:9b:e3:7d,192.168.10.14,62206,192.168.10.3,53,17,0.023556,4,2,2,308,138,170,127.356087,CON,0.023556
18:66:da:9b:e3:7d,00:c1:b1:14:eb:31,192.168.10.3,60712,192.168.10.1,53,17,0.023219,2,1,1,176,80,96,43.068176,CON,0.023219
b8:ac:6f:36:07:ee,00:c1:b1:14:eb:31,192.168.10.14,50722,192.0.77.2,443,6,0.382076,36,18,18,17638,1904,15734,91.604813,sSEfF,0.382076
b8:ac:6f:36:07:ee,18:66:da:9b:e3:7d,192.168.10.14,54810,192.168.10.3,53,17,0.000183,4,2,2,308,138,170,16393.443359,CON,0.000183
b8:ac:6f:36:07:ee,00:c1:b1:14:eb:31,192.168.10.14,50723,192.0.77.2,443,6,0.681615,99,40,59,65685,3951,61734,143.776184,sSE,0.681615
b8:ac:6f:36:07:ee,00:c1:b1:14:eb:31,192.168.10.14,50724,192.0.77.2,443,6,0.381215,34,17,17,12619,1843,10776,86.565323,sSEfF,0.381215
b8:ac:6f:36:07:ee,18:66:da:9b:e3:7d,192.168.10.14,52001,192.168.10.3,53,17,0.023566,4,2,2,400,138,262,127.302048,CON,0.023566
18:66:da:9b:e3:7d,00:c1:b1:14:eb:31,192.168.10.3,61810,192.168.10.1,53,17,0.023219,2,1,1,222,80,142,43.068176,CON,0.023219
b8:ac:6f:36:07:ee,00:c1:b1:14:eb:31,192.168.10.14,50725,192.0.77.2,443,6,0.424897,19,12,7,3452,1225,2227,42.363209,sSEfF,0.424897
b8:ac:6f:36:07:ee,00:c1:b1:14:eb:31,192.168.10.14,50726,192.0.77.2,443,6,0.424350,21,12,9,6480,1225,5255,47.130905,sSEfF,0.424350
b8:ac:6f:36:07:ee,00:c1:b1:14:eb:31,192.168.10.14,50727,192.0.77.2,443,6,0.405914,21,12,9,6480,1225,5255,49.271519,sSEfF,0.405914
b8:ac:6f:36:07:ee,00:c1:b1:14:eb:31,192.168.10.14,50614,151.101.210.2,443,6,4.689776,10,6,4,770,465,305,1.919068,sSEfFR,4.689776
b8:ac:6f:36:07:ee,00:c1:b1:14:eb:31,192.168.10.14,50728,192.0.77.2,443,6,0.646362,84,46,38,48194,3568,44626,128.411011,sSEfF,0.646362
b8:ac:6f:36:07:ee,00:c1:b1:14:eb:31,192.168.10.14,50729,192.0.77.2,443,6,0.065306,6,4,2,372,246,126,76.562645,sSEf,0.065306
b8:ac:6f:36:07:ee,00:c1:b1:14:eb:31,192.168.10.14,50730,192.0.77.2,443,6,0.648174,20,11,9,6420,1165,5255,29.313118,sSEfR,0.648174
b8:ac:6f:36:07:ee,00:c1:b1:14:eb:31,192.168.10.14,50731,192.0.77.2,443,6,0.647056,19,10,9,4991,1105,3886,27.818304,sSEfR,0.647056
b8:ac:6f:36:07:ee,00:c1:b1:14:eb:31,192.168.10.14,50732,192.0.77.2,443,6,0.059040,6,4,2,372,246,126,84.688347,sSEf,0.059040
b8:ac:6f:36:07:ee,00:c1:b1:14:eb:31,192.168.10.14,50733,192.0.77.2,443,6,0.865973,21,12,9,6480,1225,5255,23.095407,sSEfF,0.865973
b8:ac:6f:36:07:ee,18:66:da:9b:e3:7d,192.168.10.14,58853,192.168.10.3,53,17,0.025331,4,2,2,308,138,170,118.431961,CON,0.025331
b8:ac:6f:36:07:ee,18:66:da:9b:e3:7d,192.168.10.14,60770,192.168.10.3,53,17,0.000152,4,2,2,308,138,170,19736.843750,CON,0.000152
18:66:da:9b:e3:7d,00:c1:b1:14:eb:31,192.168.10.3,61621,192.168.10.1,53,17,0.025006,2,1,1,176,80,96,39.990402,CON,0.025006
b8:ac:6f:36:0b:a8,00:c1:b1:14:eb:31,192.168.10.51,47237,54.192.37.237,443,6,0.031050,5,3,2,361,229,132,128.824478,sSEfF,0.031050
b8:ac:6f:36:0a:8b,00:c1:b1:14:eb:31,192.168.10.5,49435,23.217.49.37,443,6,0.032883,2,1,1,126,60,66,30.410851,sSE,0.032883
b8:ac:6f:36:07:ee,18:66:da:9b:e3:7d,192.168.10.14,49290,192.168.10.3,53,17,0.219488,8,4,4,800,276,524,31.892405,CON,0.219488
18:66:da:9b:e3:7d,00:c1:b1:14:eb:31,192.168.10.3,60158,192.168.10.1,53,17,0.023464,2,1,1,222,80,142,42.618481,CON,0.023464
b8:ac:6f:36:07:ee,18:66:da:9b:e3:7d,192.168.10.14,52371,192.168.10.3,53,17,0.048789,4,2,2,452,172,280,61.489273,CON,0.048789
18:66:da:9b:e3:7d,00:c1:b1:14:eb:31,192.168.10.3,61381,192.168.10.1,53,17,0.048347,2,1,1,248,97,151,20.683807,CON,0.048347
b8:ac:6f:36:07:ee,00:c1:b1:14:eb:31,192.168.10.14,50653,23.61.187.27,80,6,0.036759,2,1,1,126,60,66,27.204222,sSE,0.036759
b8:ac:6f:36:07:ee,18:66:da:9b:e3:7d,192.168.10.14,53652,192.168.10.3,53,17,0.131825,8,4,4,928,344,584,53.100700,CON,0.131825
18:66:da:9b:e3:7d,00:c1:b1:14:eb:31,192.168.10.3,60726,192.168.10.1,53,17,0.047798,2,1,1,254,97,157,20.921377,CON,0.047798
b8:ac:6f:36:07:ee,18:66:da:9b:e3:7d,192.168.10.14,52018,192.168.10.3,53,17,0.000232,4,2,2,308,138,170,12931.034180,CON,0.000232
b8:ac:6f:36:07:ee,18:66:da:9b:e3:7d,192.168.10.14,63531,192.168.10.3,53,17,0.130240,8,4,4,800,276,524,53.746933,CON,0.130240
18:66:da:9b:e3:7d,00:c1:b1:14:eb:31,192.168.10.3,61544,192.168.10.1,53,17,0.023539,2,1,1,222,80,142,42.482689,CON,0.023539
b8:ac:6f:36:04:e3,00:c1:b1:14:eb:31,192.168.10.12,58802,172.217.10.46,80,6,0.036547,2,1,1,132,66,66,27.362026,sSE,0.036547
b8:ac:6f:36:04:e3,00:c1:b1:14:eb:31,192.168.10.12,58804,172.217.10.46,80,6,0.036546,2,1,1,132,66,66,27.362776,sSE,0.036546
b8:ac:6f:36:07:ee,18:66:da:9b:e3:7d,192.168.10.14,58813,192.168.10.3,53,17,0.064779,4,2,2,470,172,298,46.311306,CON,0.064779
18:66:da:9b:e3:7d,00:c1:b1:14:eb:31,192.168.10.3,62290,192.168.10.1,53,17,0.064585,2,1,1,257,97,160,15.483471,CON,0.064585
b8:ac:6f:36:07:ee,18:66:da:9b:e3:7d,192.168.10.14,50002,192.168.10.3,53,17,0.024087,4,2,2,446,166,280,124.548508,CON,0.024087
18:66:da:9b:e3:7d,00:c1:b1:14:eb:31,192.168.10.3,60722,192.168.10.1,53,17,0.023532,2,1,1,245,94,151,42.495327,CON,0.023532
b8:ac:6f:36:07:ee,00:c1:b1:14:eb:31,192.168.10.14,50734,192.0.77.2,443,6,0.473429,20,11,9,6420,1165,5255,40.132732,sSEfF,0.473429
b8:ac:6f:36:07:ee,00:c1:b1:14:eb:31,192.168.10.14,50681,52.84.143.196,443,6,0.022096,4,3,1,265,205,60,135.771179,sSEfF,0.022096
00:23:ae:9b:8a:bf,00:c1:b1:14:eb:31,192.168.10.16,45876,23.194.141.104,443,6,0.023499,7,4,3,512,283,229,255.330002,sSEfFR,0.023499
b8:ac:6f:36:04:e3,00:c1:b1:14:eb:31,192.168.10.12,58800,172.217.10.46,80,6,0.036228,2,1,1,132,66,66,27.602959,sSE,0.036228
b8:ac:6f:36:07:ee,00:c1:b1:14:eb:31,192.168.10.14,50655,52.84.142.241,443,6,0.022011,2,1,1,126,60,66,45.431828,sSE,0.022011
b8:ac:6f:36:07:ee,00:c1:b1:14:eb:31,192.168.10.14,50660,23.61.187.27,80,6,0.036692,2,1,1,126,60,66,27.253897,sSE,0.036692
b8:ac:6f:36:07:ee,00:c1:b1:14:eb:31,192.168.10.14,50569,172.217.11.2,443,6,0.036672,5,3,2,325,205,120,109.075043,sSEfF,0.036672
b8:ac:6f:36:07:ee,00:c1:b1:14:eb:31,192.168.10.14,50659,23.61.187.27,80,6,1.871197,5,3,2,724,598,126,2.137669,sSE,1.871197
b8:ac:6f:36:0b:a8,00:c1:b1:14:eb:31,192.168.10.51,40653,72.21.81.48,443,6,0.071406,8,5,3,530,325,205,98.030975,sSEfFR,0.071406
b8:ac:6f:36:0b:a8,00:c1:b1:14:eb:31,192.168.10.51,44211,172.217.12.163,443,6,0.036538,4,3,1,295,229,66,82.106300,sSEfF,0.036538
b8:ac:6f:36:0b:a8,00:c1:b1:14:eb:31,192.168.10.51,40652,72.21.81.48,443,6,0.069513,10,6,4,650,385,265,129.472183,sSEfR,0.069513
b8:ac:6f:36:0b:a8,00:c1:b1:14:eb:31,192.168.10.51,44216,172.217.12.163,443,6,0.036527,4,3,1,295,229,66,82.131027,sSEfF,0.036527
b8:ac:6f:36:0b:a8,00:c1:b1:14:eb:31,192.168.10.51,44214,172.217.12.163,443,6,0.036574,4,3,1,295,229,66,82.025482,sSEfF,0.036574
b8:ac:6f:36:0b:a8,00:c1:b1:14:eb:31,192.168.10.51,44213,172.217.12.163,443,6,0.036712,4,3,1,295,229,66,81.717155,sSEfF,0.036712
b8:ac:6f:36:0b:a8,00:c1:b1:14:eb:31,192.168.10.51,54803,172.217.10.14,443,6,0.036033,4,3,1,295,229,66,83.257011,sSEfF,0.036033
b8:ac:6f:36:0b:a8,00:c1:b1:14:eb:31,192.168.10.51,44212,172.217.12.163,443,6,0.036456,4,3,1,295,229,66,82.290977,sSEfF,0.036456
00:23:ae:9b:ad:b3,00:c1:b1:14:eb:31,192.168.10.19,123,69.164.202.202,123,17,0.057492,2,1,1,180,90,90,17.393724,CON,0.057492
b8:ac:6f:36:0b:a8,00:c1:b1:14:eb:31,192.168.10.51,33432,157.240.2.35,443,6,0.035086,3,2,1,280,173,107,57.002796,sSE,0.035086
b8:ac:6f:36:0b:a8,00:c1:b1:14:eb:31,192.168.10.51,49328,31.13.80.12,443,6,0.022117,3,2,1,280,173,107,90.428177,sSE,0.022117
00:23:ae:9b:95:67,00:c1:b1:14:eb:31,192.168.10.17,38408,202.77.129.230,443,6,0.223505,2,1,1,120,60,60,4.474173,sSE,0.223505
b8:ac:6f:36:08:f5,18:66:da:9b:e3:7d,192.168.10.8,54957,192.168.10.3,53,17,0.000004,2,0,2,274,0,274,250000.000000,RSP,0.000004
b8:ac:6f:1d:1f:6c,00:c1:b1:14:eb:31,192.168.10.9,1499,204.93.43.16,80,6,0.019962,3,2,1,180,120,60,100.190361,sSEfF,0.019962
b8:ac:6f:1d:1f:6c,00:c1:b1:14:eb:31,192.168.10.9,1500,204.93.43.16,80,6,0.019881,3,2,1,180,120,60,100.598557,sSEfF,0.019881
b8:ac:6f:1d:1f:6c,00:c1:b1:14:eb:31,192.168.10.9,1501,204.93.43.16,80,6,0.019880,3,2,1,180,120,60,100.603622,sSEfF,0.019880
b8:ac:6f:1d:1f:6c,00:c1:b1:14:eb:31,192.168.10.9,1502,204.93.43.16,80,6,0.020105,3,2,1,180,120,60,99.477737,sSEfF,0.020105
b8:ac:6f:1d:1f:6c,00:c1:b1:14:eb:31,192.168.10.9,1498,204.93.43.16,80,6,0.020095,3,2,1,180,120,60,99.527245,sSEfF,0.020095
b8:ac:6f:1d:1f:6c,00:c1:b1:14:eb:31,192.168.10.9,1496,54.192.37.170,443,6,0.029727,5,3,2,325,205,120,134.557800,sSEfF,0.029727
b8:ac:6f:36:07:ee,18:66:da:9b:e3:7d,192.168.10.14,60936,192.168.10.3,53,17,0.024068,4,2,2,394,152,242,124.646835,CON,0.024068
18:66:da:9b:e3:7d,00:c1:b1:14:eb:31,192.168.10.3,61336,192.168.10.1,53,17,0.023563,2,1,1,212,98,114,42.439419,CON,0.023563
b8:ac:6f:36:07:ee,18:66:da:9b:e3:7d,192.168.10.14,62330,192.168.10.3,53,17,0.000185,4,2,2,380,174,206,16216.216797,CON,0.000185
b8:ac:6f:36:07:ee,18:66:da:9b:e3:7d,192.168.10.14,60468,192.168.10.3,53,17,0.023618,4,2,2,404,174,230,127.021767,CON,0.023618
18:66:da:9b:e3:7d,00:c1:b1:14:eb:31,192.168.10.3,62513,192.168.10.1,53,17,0.023241,2,1,1,224,98,126,43.027409,CON,0.023241
b8:ac:6f:36:07:ee,00:c1:b1:14:eb:31,192.168.10.14,50735,157.240.18.35,443,6,3.971701,29,14,15,8586,2317,6269,7.049876,sSE,3.971701
18:66:da:9b:e3:7d,b8:ac:6f:36:0b:a8,192.168.10.3,,192.168.10.51,,2054,0.000089,4,2,2,240,120,120,33707.863281,CON,0.000089
b8:ac:6f:36:07:ee,18:66:da:9b:e3:7d,192.168.10.14,52415,192.168.10.3,53,17,0.024150,4,2,2,536,168,368,124.223595,CON,0.024150
18:66:da:9b:e3:7d,00:c1:b1:14:eb:31,192.168.10.3,60508,192.168.10.1,53,17,0.023676,2,1,1,204,94,110,42.236862,CON,0.023676
b8:ac:6f:36:07:ee,00:c1:b1:14:eb:31,192.168.10.14,50736,23.12.36.193,443,6,0.153787,16,8,8,7223,1176,6047,97.537498,sSE,0.153787
b8:ac:6f:36:07:ee,00:c1:b1:14:eb:31,192.168.10.14,50737,23.12.36.193,443,6,0.154025,16,8,8,7213,1318,5895,97.386787,sSE,0.154025
b8:ac:6f:36:07:ee,18:66:da:9b:e3:7d,192.168.10.14,58679,192.168.10.3,53,17,0.000207,4,2,2,364,166,198,14492.752930,CON,0.000207
b8:ac:6f:36:07:ee,18:66:da:9b:e3:7d,192.168.10.14,60377,192.168.10.3,53,17,0.000018,4,2,2,456,166,290,166666.656250,CON,0.000018
b8:ac:6f:36:07:ee,18:66:da:9b:e3:7d,192.168.10.14,49859,192.168.10.3,53,17,0.071012,4,2,2,428,158,270,42.246384,CON,0.071012
18:66:da:9b:e3:7d,00:c1:b1:14:eb:31,192.168.10.3,61813,192.168.10.1,53,17,0.070556,2,1,1,236,90,146,14.173139,CON,0.070556
b8:ac:6f:36:07:ee,00:c1:b1:14:eb:31,192.168.10.14,50738,23.12.36.193,443,6,0.256101,14,7,7,6305,741,5564,50.761219,sSE,0.256101
b8:ac:6f:36:07:ee,18:66:da:9b:e3:7d,192.168.10.14,59375,192.168.10.3,53,17,0.000217,4,2,2,376,172,204,13824.884766,CON,0.000217
b8:ac:6f:36:07:ee,18:66:da:9b:e3:7d,192.168.10.14,62855,192.168.10.3,53,17,0.048579,4,2,2,480,172,308,61.755081,CON,0.048579
18:66:da:9b:e3:7d,00:c1:b1:14:eb:31,192.168.10.3,61475,192.168.10.1,53,17,0.048337,2,1,1,262,97,165,20.688086,CON,0.048337
b8:ac:6f:36:07:ee,00:c1:b1:14:eb:31,192.168.10.14,50739,63.140.38.156,443,6,3.071139,23,11,12,9654,3269,6385,7.163466,sSE,3.071139
b8:ac:6f:36:07:ee,00:c1:b1:14:eb:31,192.168.10.14,50740,63.140.38.156,443,6,0.321928,16,7,9,6256,736,5520,46.594269,sSE,0.321928
b8:ac:6f:36:07:ee,00:c1:b1:14:eb:31,192.168.10.14,50684,52.90.105.35,443,6,0.050696,4,3,1,287,227,60,59.176266,sSEfF,0.050696
b8:ac:6f:36:07:ee,00:c1:b1:14:eb:31,192.168.10.14,50685,72.21.206.141,443,6,0.051940,4,3,1,265,205,60,57.758949,sSEfF,0.051940
b8:ac:6f:36:07:ee,18:66:da:9b:e3:7d,192.168.10.14,61618,192.168.10.3,53,17,0.049114,4,2,2,526,216,310,61.082378,CON,0.049114
18:66:da:9b:e3:7d,00:c1:b1:14:eb:31,192.168.10.3,61808,192.168.10.1,53,17,0.048413,2,1,1,218,101,117,20.655609,CON,0.048413
b8:ac:6f:36:07:ee,00:c1:b1:14:eb:31,192.168.10.14,50594,172.217.10.74,443,6,0.132971,14,5,9,2976,505,2471,97.765678,sSE,0.132971
b8:ac:6f:36:07:ee,00:c1:b1:14:eb:31,192.168.10.14,50688,68.67.178.170,443,6,3.340576,7,4,3,5709,2113,3596,1.796098,sSE,3.340576
b8:ac:6f:36:07:ee,00:c1:b1:14:eb:31,192.168.10.14,50741,54.231.134.96,443,6,0.356733,23,11,12,8002,1363,6639,61.670773,sSE,0.356733
b8:ac:6f:36:07:ee,18:66:da:9b:e3:7d,192.168.10.14,49302,192.168.10.3,53,17,0.000170,4,2,2,392,180,212,17647.058594,CON,0.000170
b8:ac:6f:36:04:e3,00:c1:b1:14:eb:31,192.168.10.12,46544,23.205.18.73,443,6,0.022931,2,1,1,132,66,66,43.609089,sSE,0.022931
b8:ac:6f:36:07:ee,00:c1:b1:14:eb:31,192.168.10.14,50742,178.255.83.1,80,6,0.182161,10,5,5,1890,730,1160,49.406841,sSEfF,0.182161
b8:ac:6f:36:07:ee,00:c1:b1:14:eb:31,192.168.10.14,50743,178.255.83.1,80,6,2.878755,12,6,6,2020,795,1225,3.821096,sSEfF,2.878755
b8:ac:6f:36:07:ee,00:c1:b1:14:eb:31,192.168.10.14,50744,54.231.134.96,443,6,0.366818,16,7,9,4467,765,3702,40.892212,sSE,0.366818
b8:ac:6f:36:07:ee,00:c1:b1:14:eb:31,192.168.10.14,50654,52.84.144.121,443,6,0.022157,2,1,1,126,60,66,45.132462,sSE,0.022157
b8:ac:6f:36:07:ee,18:66:da:9b:e3:7d,192.168.10.14,57806,192.168.10.3,53,17,0.046696,4,2,2,430,156,274,64.245331,CON,0.046696
18:66:da:9b:e3:7d,00:c1:b1:14:eb:31,192.168.10.3,60131,192.168.10.1,53,17,0.046215,2,1,1,237,89,148,21.637995,CON,0.046215
b8:ac:6f:36:07:ee,18:66:da:9b:e3:7d,192.168.10.14,59897,192.168.10.3,53,17,0.023801,4,2,2,356,162,194,126.045120,CON,0.023801
18:66:da:9b:e3:7d,00:c1:b1:14:eb:31,192.168.10.3,61823,192.168.10.1,53,17,0.023400,2,1,1,200,92,108,42.735043,CON,0.023400
b8:ac:6f:36:07:ee,18:66:da:9b:e3:7d,192.168.10.14,60805,192.168.10.3,53,17,0.000220,4,2,2,534,168,366,13636.363281,CON,0.000220
b8:ac:6f:36:07:ee,00:c1:b1:14:eb:31,192.168.10.14,50745,23.208.217.175,443,6,0.302518,16,7,9,7535,741,6794,49.583824,sSE,0.302518
b8:ac:6f:1d:1f:6c,00:c1:b1:14:eb:31,192.168.10.9,1497,204.93.43.16,80,6,0.019921,3,2,1,180,120,60,100.396568,sSEfF,0.019921
b8:ac:6f:1d:1f:6c,00:c1:b1:14:eb:31,192.168.10.9,1521,23.50.75.27,80,6,0.023203,3,2,1,180,120,60,86.195747,sSEfF,0.023203
b8:ac:6f:36:07:ee,00:c1:b1:14:eb:31,192.168.10.14,50746,23.208.217.175,443,6,0.254535,12,6,6,4955,681,4274,43.216061,sSE,0.254535
b8:ac:6f:36:07:ee,00:c1:b1:14:eb:31,192.168.10.14,50747,161.170.238.122,443,6,0.302994,16,7,9,6982,1350,5632,49.505928,sSE,0.302994
b8:ac:6f:36:07:ee,00:c1:b1:14:eb:31,192.168.10.14,50748,161.170.238.122,443,6,0.250216,12,6,6,5625,891,4734,43.962017,sSE,0.250216
b8:ac:6f:36:07:ee,00:c1:b1:14:eb:31,192.168.10.14,50749,72.21.206.140,443,6,4.120049,20,12,8,7770,2486,5284,4.611596,sSE,4.120049
b8:ac:6f:36:07:ee,00:c1:b1:14:eb:31,192.168.10.14,50750,72.21.206.140,443,6,0.175903,15,8,7,5199,1237,3962,79.589317,sSE,0.175903
b8:ac:6f:36:07:ee,18:66:da:9b:e3:7d,192.168.10.14,58113,192.168.10.3,53,17,0.046793,4,2,2,674,142,532,64.112152,CON,0.046793
b8:ac:6f:36:07:ee,18:66:da:9b:e3:7d,192.168.10.14,62011,192.168.10.3,53,17,0.047996,4,2,2,430,158,272,62.505211,CON,0.047996
18:66:da:9b:e3:7d,00:c1:b1:14:eb:31,192.168.10.3,60425,192.168.10.1,53,17,0.046416,2,1,1,359,82,277,21.544294,CON,0.046416
b8:ac:6f:36:07:ee,18:66:da:9b:e3:7d,192.168.10.14,54975,192.168.10.3,53,17,0.095477,4,2,2,644,174,470,31.421181,CON,0.095477
18:66:da:9b:e3:7d,00:c1:b1:14:eb:31,192.168.10.3,62103,192.168.10.1,53,17,0.047589,2,1,1,237,90,147,21.013260,CON,0.047589
b8:ac:6f:36:07:ee,18:66:da:9b:e3:7d,192.168.10.14,50647,192.168.10.3,53,17,0.061733,4,2,2,548,146,402,48.596375,CON,0.061733
18:66:da:9b:e3:7d,00:c1:b1:14:eb:31,192.168.10.3,60170,192.168.10.1,53,17,0.095013,2,1,1,344,98,246,10.524876,CON,0.095013
b8:ac:6f:36:07:ee,18:66:da:9b:e3:7d,192.168.10.14,62228,192.168.10.3,53,17,0.025274,4,2,2,450,172,278,118.699059,CON,0.025274
18:66:da:9b:e3:7d,00:c1:b1:14:eb:31,192.168.10.3,60540,192.168.10.1,53,17,0.061251,2,1,1,296,84,212,16.326263,CON,0.061251
b8:ac:6f:36:07:ee,18:66:da:9b:e3:7d,192.168.10.14,58633,192.168.10.3,53,17,0.000182,4,2,2,468,170,298,16483.515625,CON,0.000182
18:66:da:9b:e3:7d,00:c1:b1:14:eb:31,192.168.10.3,61444,192.168.10.1,53,17,0.024883,2,1,1,247,97,150,40.188080,CON,0.024883
b8:ac:6f:36:07:ee,18:66:da:9b:e3:7d,192.168.10.14,55173,192.168.10.3,53,17,0.078393,4,2,2,424,172,252,38.268723,CON,0.078393
18:66:da:9b:e3:7d,00:c1:b1:14:eb:31,192.168.10.3,61811,192.168.10.1,53,17,0.078026,2,1,1,234,97,137,12.816241,CON,0.078026
b8:ac:6f:36:07:ee,18:66:da:9b:e3:7d,192.168.10.14,62510,192.168.10.3,53,17,0.025211,4,2,2,590,146,444,118.995674,CON,0.025211
18:66:da:9b:e3:7d,00:c1:b1:14:eb:31,192.168.10.3,60972,192.168.10.1,53,17,0.024730,2,1,1,302,87,215,40.436714,CON,0.024730
b8:ac:6f:36:07:ee,18:66:da:9b:e3:7d,192.168.10.14,56848,192.168.10.3,53,17,0.047966,4,2,2,474,156,318,62.544304,CON,0.047966
18:66:da:9b:e3:7d,00:c1:b1:14:eb:31,192.168.10.3,61127,192.168.10.1,53,17,0.047615,2,1,1,259,89,170,21.001785,CON,0.047615
b8:ac:6f:36:07:ee,18:66:da:9b:e3:7d,192.168.10.14,54237,192.168.10.3,53,17,0.023848,4,2,2,336,152,184,125.796707,CON,0.023848
18:66:da:9b:e3:7d,00:c1:b1:14:eb:31,192.168.10.3,62453,192.168.10.1,53,17,0.023518,2,1,1,190,87,103,42.520622,CON,0.023518
b8:ac:6f:36:07:ee,00:c1:b1:14:eb:31,192.168.10.14,50676,104.16.25.216,80,6,0.022095,2,2,0,565,565,0,45.259109,sSE,0.022095
b8:ac:6f:36:07:ee,00:c1:b1:14:eb:31,192.168.10.14,50675,104.16.25.216,80,6,0.018816,4,2,2,2822,565,2257,159.438782,sSE,0.018816
00:25:00:a8:c4:60,18:66:da:9b:e3:7d,192.168.10.25,53829,192.168.10.3,53,17,0.097905,4,2,2,444,182,262,30.641949,CON,0.097905
18:66:da:9b:e3:7d,00:c1:b1:14:eb:31,192.168.10.3,62158,192.168.10.1,53,17,0.097402,2,1,1,244,102,142,10.266729,CON,0.097402
b8:ac:6f:36:07:ee,18:66:da:9b:e3:7d,192.168.10.14,60244,192.168.10.3,53,17,0.060166,4,2,2,432,172,260,49.862049,CON,0.060166
18:66:da:9b:e3:7d,00:c1:b1:14:eb:31,192.168.10.3,62372,192.168.10.1,53,17,0.059977,2,1,1,238,97,141,16.673058,CON,0.059977
b8:ac:6f:36:07:ee,00:c1:b1:14:eb:31,192.168.10.14,50751,185.86.139.58,443,6,0.737538,15,7,8,4688,744,3944,18.982073,sSE,0.737538
b8:ac:6f:36:07:ee,00:c1:b1:14:eb:31,192.168.10.14,50752,185.86.139.58,443,6,0.637446,17,8,9,5739,1292,4447,25.100166,sSE,0.637446
b8:ac:6f:36:07:ee,00:c1:b1:14:eb:31,192.168.10.14,50753,162.208.22.39,443,6,0.182861,14,7,7,5870,1208,4662,71.092247,sSE,0.182861
b8:ac:6f:36:07:ee,00:c1:b1:14:eb:31,192.168.10.14,50754,54.172.7.186,443,6,0.336108,17,9,8,6616,1262,5354,47.603748,sSE,0.336108
b8:ac:6f:36:07:ee,00:c1:b1:14:eb:31,192.168.10.14,50755,50.18.61.120,443,6,3.035835,17,9,8,7192,1702,5490,5.270379,sSE,3.035835
b8:ac:6f:36:07:ee,00:c1:b1:14:eb:31,192.168.10.14,50756,52.89.104.64,443,6,0.388760,12,7,5,3729,1200,2529,28.295092,sSE,0.388760
b8:ac:6f:36:07:ee,00:c1:b1:14:eb:31,192.168.10.14,50757,52.89.104.64,443,6,0.647370,12,7,5,2584,734,1850,16.991829,sSE,0.647370
b8:ac:6f:36:0a:8b,00:c1:b1:14:eb:31,192.168.10.5,49504,104.154.73.75,443,6,0.046143,3,2,1,180,120,60,43.343521,sSEfF,0.046143
b8:ac:6f:36:0a:8b,00:c1:b1:14:eb:31,192.168.10.5,49254,43.251.41.28,443,6,0.283780,4,2,2,1529,731,798,10.571569,E,0.283780
b8:ac:6f:36:07:ee,18:66:da:9b:e3:7d,192.168.10.14,62238,192.168.10.3,53,17,0.000258,4,2,2,590,146,444,11627.907227,CON,0.000258
b8:ac:6f:36:07:ee,00:c1:b1:14:eb:31,192.168.10.14,50758,72.30.2.182,443,6,0.292326,22,10,12,6986,1671,5315,71.837608,sSE,0.292326
00:25:00:a8:c4:60,00:c1:b1:14:eb:31,192.168.10.25,49328,172.217.6.238,80,6,0.239484,25,13,12,14473,12751,1722,100.215462,sSE,0.239484
b8:ac:6f:36:07:ee,00:c1:b1:14:eb:31,192.168.10.14,50696,8.43.72.32,443,6,0.035252,5,3,2,347,227,120,113.468735,sSEfF,0.035252
b8:ac:6f:36:07:ee,00:c1:b1:14:eb:31,192.168.10.14,50695,8.43.72.32,443,6,0.035102,5,3,2,347,227,120,113.953629,sSEfF,0.035102
b8:ac:6f:36:07:ee,00:c1:b1:14:eb:31,192.168.10.14,50694,8.43.72.32,443,6,0.035270,5,3,2,347,227,120,113.410828,sSEfF,0.035270
b8:ac:6f:36:07:ee,00:c1:b1:14:eb:31,192.168.10.14,50692,68.67.178.170,443,6,0.032352,5,3,2,325,205,120,123.639961,sSEfF,0.032352
b8:ac:6f:36:07:ee,00:c1:b1:14:eb:31,192.168.10.14,50693,68.67.178.170,443,6,0.032300,5,3,2,325,205,120,123.839012,sSEfF,0.032300
b8:ac:6f:36:07:ee,00:c1:b1:14:eb:31,192.168.10.14,50699,8.43.72.32,443,6,0.035019,4,3,1,287,227,60,85.667786,sSEfF,0.035019
b8:ac:6f:36:07:ee,00:c1:b1:14:eb:31,192.168.10.14,50697,8.43.72.32,443,6,0.036130,4,3,1,287,227,60,83.033493,sSEfF,0.036130
b8:ac:6f:36:07:ee,00:c1:b1:14:eb:31,192.168.10.14,50698,8.43.72.32,443,6,0.037592,5,3,2,347,227,120,106.405617,sSEfF,0.037592
00:23:ae:9b:95:67,00:c1:b1:14:eb:31,192.168.10.17,43753,202.77.129.146,443,6,0.000000,1,0,1,60,0,60,0.000000,sSEfF,0.000000
b8:ac:6f:1d:1f:6c,00:c1:b1:14:eb:31,192.168.10.9,1508,172.217.12.163,443,6,0.236754,3,2,1,260,160,100,8.447587,sSE,0.236754
b8:ac:6f:1d:1f:6c,00:c1:b1:14:eb:31,192.168.10.9,1504,172.217.6.232,443,6,0.239744,3,2,1,260,160,100,8.342232,sSE,0.239744
b8:ac:6f:1d:1f:6c,00:c1:b1:14:eb:31,192.168.10.9,1494,93.184.216.182,443,6,0.229730,3,2,1,260,160,100,8.705873,sSE,0.229730
b8:ac:6f:36:07:ee,18:66:da:9b:e3:7d,192.168.10.14,59650,192.168.10.3,53,17,0.000196,4,2,2,388,178,210,15306.123047,CON,0.000196
b8:ac:6f:36:07:ee,18:66:da:9b:e3:7d,192.168.10.14,55123,192.168.10.3,53,17,0.000078,4,2,2,356,162,194,38461.539062,CON,0.000078
b8:ac:6f:36:07:ee,18:66:da:9b:e3:7d,192.168.10.14,63522,192.168.10.3,53,17,0.000202,4,2,2,560,152,408,14851.485352,CON,0.000202
b8:ac:6f:36:07:ee,18:66:da:9b:e3:7d,192.168.10.14,50806,192.168.10.3,53,17,0.077949,4,2,2,488,178,310,38.486702,CON,0.077949
18:66:da:9b:e3:7d,00:c1:b1:14:eb:31,192.168.10.3,62421,192.168.10.1,53,17,0.077567,2,1,1,266,100,166,12.892079,CON,0.077567
b8:ac:6f:36:07:ee,18:66:da:9b:e3:7d,192.168.10.14,49858,192.168.10.3,53,17,0.024336,4,2,2,434,162,272,123.274155,CON,0.024336
18:66:da:9b:e3:7d,00:c1:b1:14:eb:31,192.168.10.3,62399,192.168.10.1,53,17,0.023919,2,1,1,239,92,147,41.807770,CON,0.023919
b8:ac:6f:36:07:ee,18:66:da:9b:e3:7d,192.168.10.14,58087,192.168.10.3,53,17,0.000178,4,2,2,456,164,292,16853.931641,CON,0.000178
b8:ac:6f:36:07:ee,00:c1:b1:14:eb:31,192.168.10.14,50759,52.55.125.33,443,6,0.200424,17,8,9,7242,1199,6043,79.830757,sSE,0.200424
00:1e:4f:d4:ca:28,00:c1:b1:14:eb:31,192.168.10.15,49477,23.194.142.4,443,6,0.023596,4,2,2,265,120,145,127.140190,fR,0.023596
b8:ac:6f:36:07:ee,18:66:da:9b:e3:7d,192.168.10.14,52428,192.168.10.3,53,17,0.023625,4,2,2,448,164,284,126.984131,CON,0.023625
18:66:da:9b:e3:7d,00:c1:b1:14:eb:31,192.168.10.3,60170,192.168.10.1,53,17,0.023259,2,1,1,246,93,153,42.994110,CON,0.023259
b8:ac:6f:36:07:ee,18:66:da:9b:e3:7d,192.168.10.14,52180,192.168.10.3,53,17,0.000156,4,2,2,336,152,184,19230.769531,CON,0.000156
b8:ac:6f:36:07:ee,18:66:da:9b:e3:7d,192.168.10.14,55538,192.168.10.3,53,17,0.000197,4,2,2,548,146,402,15228.426758,CON,0.000197
b8:ac:6f:36:07:ee,18:66:da:9b:e3:7d,192.168.10.14,58136,192.168.10.3,53,17,0.024029,4,2,2,434,152,282,124.849144,CON,0.024029
18:66:da:9b:e3:7d,00:c1:b1:14:eb:31,192.168.10.3,61768,192.168.10.1,53,17,0.023716,2,1,1,239,87,152,42.165627,CON,0.023716
b8:ac:6f:36:07:ee,18:66:da:9b:e3:7d,192.168.10.14,63160,192.168.10.3,53,17,0.024092,4,2,2,462,146,316,124.522667,CON,0.024092
18:66:da:9b:e3:7d,00:c1:b1:14:eb:31,192.168.10.3,60301,192.168.10.1,53,17,0.023676,2,1,1,253,84,169,42.236862,CON,0.023676
b8:ac:6f:36:07:ee,00:c1:b1:14:eb:31,192.168.10.14,50670,89.145.95.52,443,6,0.093760,5,2,3,325,120,205,42.662117,sSEfF,0.093760
00:c1:b1:14:eb:31,00:23:ae:9b:8a:bf,191.237.24.89,443,192.168.10.16,34436,6,0.000085,2,1,1,185,119,66,11764.706055,E,0.000085
b8:ac:6f:36:07:ee,18:66:da:9b:e3:7d,192.168.10.14,60299,192.168.10.3,53,17,0.000175,4,2,2,444,158,286,17142.857422,CON,0.000175
70:6e:6d:1d:bb:03,01:00:0c:cc:cc:cc,01:00:0c:cc:cc:cc,170,70:6e:6d:1d:bb:03,170,0,0.000000,1,1,0,457,457,0,0.000000,INT,0.000000
b8:ac:6f:36:07:ee,18:66:da:9b:e3:7d,192.168.10.14,63763,192.168.10.3,53,17,0.023883,4,2,2,460,158,302,125.612358,CON,0.023883
18:66:da:9b:e3:7d,00:c1:b1:14:eb:31,192.168.10.3,61444,192.168.10.1,53,17,0.023592,2,1,1,252,90,162,42.387249,CON,0.023592
b8:ac:6f:36:07:ee,18:66:da:9b:e3:7d,192.168.10.14,63439,192.168.10.3,53,17,0.000212,4,2,2,708,226,482,14150.943359,CON,0.000212
b8:ac:6f:36:07:ee,18:66:da:9b:e3:7d,192.168.10.14,49218,192.168.10.3,53,17,0.000165,4,2,2,380,174,206,18181.818359,CON,0.000165
b8:ac:6f:36:07:ee,18:66:da:9b:e3:7d,192.168.10.14,50338,192.168.10.3,53,17,0.047799,4,2,2,488,174,314,62.762821,CON,0.047799
18:66:da:9b:e3:7d,00:c1:b1:14:eb:31,192.168.10.3,61216,192.168.10.1,53,17,0.047576,2,1,1,266,98,168,21.019001,CON,0.047576
00:1e:4f:d4:ca:28,18:66:da:9b:e3:7d,192.168.10.15,63549,192.168.10.3,53,17,0.000255,4,2,2,436,170,266,11764.706055,CON,0.000255
b8:ac:6f:36:0b:a8,00:c1:b1:14:eb:31,192.168.10.51,58427,104.16.25.235,443,6,0.015084,3,2,1,250,155,95,132.590820,sSE,0.015084
b8:ac:6f:36:07:ee,18:66:da:9b:e3:7d,192.168.10.14,55098,192.168.10.3,53,17,0.000217,4,2,2,408,172,236,13824.884766,CON,0.000217
b8:ac:6f:36:07:ee,18:66:da:9b:e3:7d,192.168.10.14,62333,192.168.10.3,53,17,0.048626,4,2,2,480,176,304,61.695393,CON,0.048626
18:66:da:9b:e3:7d,00:c1:b1:14:eb:31,192.168.10.3,62139,192.168.10.1,53,17,0.048229,2,1,1,262,99,163,20.734413,CON,0.048229
b8:ac:6f:36:07:ee,18:66:da:9b:e3:7d,192.168.10.14,50536,192.168.10.3,53,17,0.048080,4,2,2,448,170,278,62.396004,CON,0.048080
18:66:da:9b:e3:7d,00:c1:b1:14:eb:31,192.168.10.3,60163,192.168.10.1,53,17,0.047712,2,1,1,246,96,150,20.959089,CON,0.047712
b8:ac:6f:36:07:ee,18:66:da:9b:e3:7d,192.168.10.14,63679,192.168.10.3,53,17,0.048735,4,2,2,464,170,294,61.557404,CON,0.048735
18:66:da:9b:e3:7d,00:c1:b1:14:eb:31,192.168.10.3,61616,192.168.10.1,53,17,0.048388,2,1,1,254,96,158,20.666281,CON,0.048388
b8:ac:6f:36:07:ee,18:66:da:9b:e3:7d,192.168.10.14,54308,192.168.10.3,53,17,0.049045,4,2,2,464,170,294,61.168316,CON,0.049045
18:66:da:9b:e3:7d,00:c1:b1:14:eb:31,192.168.10.3,60707,192.168.10.1,53,17,0.048693,2,1,1,254,96,158,20.536833,CON,0.048693
b8:ac:6f:36:07:ee,18:66:da:9b:e3:7d,192.168.10.14,59807,192.168.10.3,53,17,0.048653,4,2,2,464,172,292,61.661152,CON,0.048653
18:66:da:9b:e3:7d,00:c1:b1:14:eb:31,192.168.10.3,61233,192.168.10.1,53,17,0.048383,2,1,1,254,97,157,20.668417,CON,0.048383
b8:ac:6f:36:07:ee,18:66:da:9b:e3:7d,192.168.10.14,57450,192.168.10.3,53,17,0.048462,4,2,2,448,170,278,61.904171,CON,0.048462
18:66:da:9b:e3:7d,00:c1:b1:14:eb:31,192.168.10.3,60393,192.168.10.1,53,17,0.048302,2,1,1,246,96,150,20.703077,CON,0.048302
b8:ac:6f:36:08:f5,00:c1:b1:14:eb:31,192.168.10.8,49269,52.43.87.30,443,6,0.083843,2,1,1,120,60,60,11.927054,sSE,0.083843
00:23:ae:9b:95:67,00:c1:b1:14:eb:31,192.168.10.17,55691,192.229.173.173,443,6,0.023052,2,1,1,132,66,66,43.380184,sSE,0.023052
00:23:ae:9b:95:67,00:c1:b1:14:eb:31,192.168.10.17,60232,202.77.129.169,443,6,0.226342,2,1,1,120,60,60,4.418093,sSE,0.226342
b8:ac:6f:36:07:ee,00:c1:b1:14:eb:31,192.168.10.14,50703,151.101.1.108,443,6,0.015275,5,3,2,350,205,145,261.865814,sSEfR,0.015275
00:23:ae:9b:95:67,00:c1:b1:14:eb:31,192.168.10.17,123,45.79.187.10,123,17,0.023655,2,1,1,180,90,90,42.274361,CON,0.023655
00:1e:4f:d4:ca:28,18:66:da:9b:e3:7d,192.168.10.15,61284,192.168.10.3,53,17,0.047083,4,2,2,562,168,394,63.717262,CON,0.047083
18:66:da:9b:e3:7d,00:c1:b1:14:eb:31,192.168.10.3,62172,192.168.10.1,53,17,0.046575,2,1,1,303,95,208,21.470747,CON,0.046575
