SrcMac,DstMac,SrcAddr,Sport,DstAddr,Dport,Proto,Mean,TotPkts,SrcPkts,DstPkts,TotBytes,SrcBytes,DstBytes,Rate,State,Dur
00:1e:4f:d4:ca:28,00:c1:b1:14:eb:31,192.168.10.15,50442,54.192.37.141,443,6,5.030060,7,4,3,451,265,186,1.192829,sSEfF,5.030060
00:1e:4f:d4:ca:28,00:c1:b1:14:eb:31,192.168.10.15,50264,199.187.193.19,443,6,4.856610,8,4,4,505,265,240,1.441335,sSEfF,4.856610
00:1e:4f:d4:ca:28,00:c1:b1:14:eb:31,192.168.10.15,50337,23.1.25.111,443,6,4.823082,8,4,4,536,265,271,1.451354,sSEfR,4.823082
00:23:ae:9b:ad:b3,18:66:da:9b:e3:7d,192.168.10.19,57588,192.168.10.3,53,17,4.055318,4,2,2,276,138,138,0.739769,CON,4.055318
00:23:ae:9b:ad:b3,18:66:da:9b:e3:7d,192.168.10.19,36839,192.168.10.3,53,17,4.055211,4,2,2,276,138,138,0.739789,CON,4.055211
b8:ac:6f:36:0a:8b,00:c1:b1:14:eb:31,192.168.10.5,51907,50.19.216.194,443,6,4.981865,4,2,2,265,120,145,0.602184,EfF,4.981865
00:23:ae:9b:8a:bf,00:c1:b1:14:eb:31,192.168.10.16,44632,178.255.83.1,80,6,3.184140,8,4,4,552,272,280,2.198396,sSEf,3.184140
00:23:ae:9b:8a:bf,00:c1:b1:14:eb:31,192.168.10.16,44636,178.255.83.1,80,6,3.184032,8,4,4,552,272,280,2.198470,sSEf,3.184032
00:1e:4f:d4:ca:28,00:c1:b1:14:eb:31,192.168.10.15,50473,52.84.26.47,443,6,4.719840,7,4,3,451,265,186,1.271230,sSEfF,4.719840
00:23:ae:9b:8a:bf,00:c1:b1:14:eb:31,192.168.10.16,47156,104.88.33.156,443,6,1.827793,15,4,11,4110,264,3846,7.659511,sSE,1.827793
b8:ac:6f:36:08:f5,00:c1:b1:14:eb:31,192.168.10.8,49419,72.21.91.29,80,6,4.931375,10,6,4,5476,2076,3400,1.825049,sSE,4.931375
b8:ac:6f:36:0a:8b,00:19:b9:0a:69:f1,192.168.10.5,52139,192.168.10.50,22,6,1.317686,82,38,44,14166,4716,9450,61.471401,sSEfF,1.317686
b8:ac:6f:1d:1f:6c,00:c1:b1:14:eb:31,192.168.10.9,62708,23.15.4.11,80,6,4.962487,6,3,3,1179,678,501,1.007559,E,4.962487
00:23:ae:9b:8a:bf,00:c1:b1:14:eb:31,192.168.10.16,54670,52.45.120.198,443,6,0.949936,21,12,9,9375,2170,7205,21.054050,sSE,0.949936
b8:ac:6f:1d:1f:6c,00:c1:b1:14:eb:31,192.168.10.9,62785,52.206.85.2,80,6,4.920160,6,3,3,1728,720,1008,1.016227,E,4.920160
00:23:ae:9b:8a:bf,00:c1:b1:14:eb:31,192.168.10.16,47850,107.21.253.211,443,6,0.641615,15,10,5,6425,4140,2285,21.819941,sSE,0.641615
b8:ac:6f:36:08:f5,00:c1:b1:14:eb:31,192.168.10.8,137,223.165.30.126,137,17,3.020242,3,3,0,276,276,0,0.662199,INT,3.020242
b8:ac:6f:1d:1f:6c,00:c1:b1:14:eb:31,192.168.10.9,62858,35.167.226.133,80,6,4.873551,6,3,3,1571,700,871,1.025946,E,4.873551
b8:ac:6f:1d:1f:6c,00:c1:b1:14:eb:31,192.168.10.9,63108,129.146.14.101,80,6,4.860389,6,3,3,1298,610,688,1.028724,E,4.860389
b8:ac:6f:1d:1f:6c,00:c1:b1:14:eb:31,192.168.10.9,63065,52.2.56.173,80,6,4.833477,14,7,7,6344,2602,3742,2.689575,E,4.833477
b8:ac:6f:1d:1f:6c,00:c1:b1:14:eb:31,192.168.10.9,63039,198.54.12.145,80,6,4.123187,6,2,4,572,120,452,1.212654,E,4.123187
00:23:ae:9b:8a:bf,00:c1:b1:14:eb:31,192.168.10.16,37700,104.211.48.17,443,6,0.196156,8,6,2,971,756,215,35.685883,sSE,0.196156
00:23:ae:9b:8a:bf,00:c1:b1:14:eb:31,192.168.10.16,37702,104.211.48.17,443,6,0.452612,15,9,6,6196,2031,4165,30.931570,sSE,0.452612
b8:ac:6f:1d:1f:6c,00:c1:b1:14:eb:31,192.168.10.9,63992,54.228.200.142,443,6,0.102143,2,1,1,126,60,66,9.790196,sSE,0.102143
00:23:ae:9b:8a:bf,00:c1:b1:14:eb:31,192.168.10.16,36164,198.51.152.184,443,6,0.138308,14,8,6,5779,803,4976,93.993111,sSE,0.138308
00:23:ae:9b:8a:bf,00:c1:b1:14:eb:31,192.168.10.16,36166,198.51.152.184,443,6,0.130164,19,10,9,9139,1496,7643,138.287094,sSE,0.130164
00:23:ae:9b:8a:bf,00:c1:b1:14:eb:31,192.168.10.16,57912,23.50.75.27,80,6,0.049405,6,4,2,844,704,140,101.204330,sSE,0.049405
00:23:ae:9b:8a:bf,00:c1:b1:14:eb:31,192.168.10.16,57914,23.50.75.27,80,6,0.067482,6,4,2,844,704,140,74.093834,sSE,0.067482
00:1e:4f:d4:ca:28,00:c1:b1:14:eb:31,192.168.10.15,50105,172.217.10.78,443,6,0.059691,3,2,1,260,160,100,33.505890,sSE,0.059691
00:1e:4f:d4:ca:28,00:c1:b1:14:eb:31,192.168.10.15,50390,144.2.1.1,443,6,0.270607,3,2,1,260,160,100,7.390792,sSE,0.270607
00:23:ae:9b:8a:bf,00:c1:b1:14:eb:31,192.168.10.16,57916,23.50.75.27,80,6,0.023053,3,2,1,214,140,74,86.756607,sSE,0.023053
00:23:ae:9b:8a:bf,00:c1:b1:14:eb:31,192.168.10.16,57918,23.50.75.27,80,6,0.023236,3,2,1,214,140,74,86.073334,sSE,0.023236
00:1e:4f:d4:ca:28,00:c1:b1:14:eb:31,192.168.10.15,50215,74.121.142.165,443,6,0.023893,2,1,1,126,60,66,41.853260,sSE,0.023893
b8:ac:6f:36:0a:8b,00:19:b9:0a:69:f1,192.168.10.5,52140,192.168.10.50,22,6,1.307615,80,38,42,13802,4780,9022,60.415333,sSEfF,1.307615
b8:ac:6f:1d:1f:6c,00:c1:b1:14:eb:31,192.168.10.9,63980,23.21.84.138,80,6,0.050518,2,1,1,120,60,60,19.794926,sSE,0.050518
00:23:ae:9b:8a:bf,00:c1:b1:14:eb:31,192.168.10.16,53112,107.23.112.131,443,6,0.051036,6,4,2,446,283,163,97.970062,sSEfFR,0.051036
00:23:ae:9b:8a:bf,00:c1:b1:14:eb:31,192.168.10.16,49594,23.194.108.19,443,6,0.023745,8,5,3,572,343,229,294.798889,sSEfFR,0.023745
00:23:ae:9b:95:67,00:c1:b1:14:eb:31,192.168.10.17,47710,184.173.177.152,443,6,0.042848,4,1,3,295,66,229,70.014938,sSEfF,0.042848
00:19:b9:0a:69:f1,00:c1:b1:14:eb:31,192.168.10.50,123,129.128.12.20,123,17,0.087229,2,1,1,180,90,90,11.464078,CON,0.087229
00:23:ae:9b:ad:b3,18:66:da:9b:e3:7d,192.168.10.19,46942,192.168.10.3,53,17,0.000093,2,0,2,138,0,138,10752.687500,RSP,0.000093
00:23:ae:9b:ad:b3,18:66:da:9b:e3:7d,192.168.10.19,37647,192.168.10.3,53,17,0.000002,2,0,2,138,0,138,500000.000000,RSP,0.000002
00:23:ae:9b:ad:b3,18:66:da:9b:e3:7d,192.168.10.19,50788,192.168.10.3,53,17,0.000002,2,2,0,138,138,0,500000.000000,INT,0.000002
00:23:ae:9b:ad:b3,18:66:da:9b:e3:7d,192.168.10.19,24388,192.168.10.3,53,17,0.000002,2,2,0,138,138,0,500000.000000,INT,0.000002
18:66:da:9b:e3:7d,00:c1:b1:14:eb:31,192.168.10.3,61843,192.168.10.1,53,17,0.319668,2,1,1,160,80,80,3.128246,CON,0.319668
18:66:da:9b:e3:7d,00:c1:b1:14:eb:31,192.168.10.3,61705,192.168.10.1,53,17,0.409757,2,1,1,160,80,80,2.440471,CON,0.409757
00:23:ae:9b:8a:bf,00:c1:b1:14:eb:31,192.168.10.16,38854,162.208.22.39,443,6,0.041434,5,2,3,325,120,205,96.539070,sSEfF,0.041434
00:1e:4f:d4:ca:28,00:c1:b1:14:eb:31,192.168.10.15,50238,151.101.20.166,443,6,0.023410,6,3,3,410,205,205,213.583939,sSEfFR,0.023410
00:1e:4f:d4:ca:28,00:c1:b1:14:eb:31,192.168.10.15,50323,192.35.249.120,443,6,0.000000,2,1,1,120,60,60,0.000000,sSEfF,0.000000
00:23:ae:9b:95:67,00:c1:b1:14:eb:31,192.168.10.17,43367,184.173.165.61,443,6,0.043025,5,1,4,602,66,536,92.969208,sSEfF,0.043025
00:23:ae:9b:8a:bf,00:c1:b1:14:eb:31,192.168.10.16,52062,23.99.229.108,443,6,0.049363,2,1,1,132,66,66,20.258089,sSE,0.049363
00:23:ae:9b:95:67,18:66:da:9b:e3:7d,192.168.10.17,,192.168.10.3,,2054,0.000012,4,2,2,240,120,120,249999.984375,CON,0.000012
00:23:ae:9b:95:67,00:c1:b1:14:eb:31,192.168.10.17,43364,184.173.165.61,443,6,0.043656,5,2,3,361,132,229,91.625435,sSEfF,0.043656
b8:ac:6f:1d:1f:6c,00:c1:b1:14:eb:31,192.168.10.9,63880,151.101.2.49,80,6,0.015318,2,1,1,126,60,66,65.282677,sSE,0.015318
00:23:ae:9b:8a:bf,00:c1:b1:14:eb:31,192.168.10.16,43274,104.88.33.156,80,6,0.023057,2,1,1,132,66,66,43.370777,sSE,0.023057
00:23:ae:9b:95:67,00:c1:b1:14:eb:31,192.168.10.17,59969,54.192.37.81,443,6,0.029358,5,3,2,361,229,132,136.249069,sSEfF,0.029358
00:23:ae:9b:95:67,00:c1:b1:14:eb:31,192.168.10.17,56077,174.37.231.137,443,6,0.043272,8,5,3,845,365,480,161.767426,sSEfFR,0.043272
00:23:ae:9b:95:67,00:c1:b1:14:eb:31,192.168.10.17,44914,74.125.22.156,443,6,0.050155,4,3,1,295,229,66,59.814575,sSEfF,0.050155
b8:ac:6f:1d:1f:6c,00:c1:b1:14:eb:31,192.168.10.9,62484,172.217.6.230,443,6,0.241094,25,6,19,2176,480,1696,99.546234,E,0.241094
b8:ac:6f:1d:1f:6c,00:c1:b1:14:eb:31,192.168.10.9,63881,172.217.10.70,80,6,0.036601,2,1,1,126,60,66,27.321659,sSE,0.036601
00:1e:4f:d4:ca:28,00:c1:b1:14:eb:31,192.168.10.15,50482,192.35.249.123,443,6,1.054096,7,3,4,4092,1603,2489,5.692081,sSE,1.054096
00:1e:4f:d4:ca:28,00:c1:b1:14:eb:31,192.168.10.15,50436,72.21.91.113,443,6,0.074093,3,2,1,260,160,100,26.993103,sSE,0.074093
00:1e:4f:d4:ca:28,00:c1:b1:14:eb:31,192.168.10.15,50163,172.217.10.78,443,6,0.060006,3,2,1,260,160,100,33.330002,sSE,0.060006
b8:ac:6f:36:08:f5,18:66:da:9b:e3:7d,192.168.10.8,59083,192.168.10.3,53,17,0.091361,4,2,2,680,166,514,32.836769,CON,0.091361
18:66:da:9b:e3:7d,00:c1:b1:14:eb:31,192.168.10.3,60593,192.168.10.1,53,17,0.090730,2,1,1,362,94,268,11.021713,CON,0.090730
00:23:ae:9b:8a:bf,00:c1:b1:14:eb:31,192.168.10.16,36710,172.217.10.142,80,6,0.035685,3,2,1,198,132,66,56.045959,sSEf,0.035685
00:23:ae:9b:8a:bf,00:c1:b1:14:eb:31,192.168.10.16,33464,216.200.232.121,443,6,0.034461,4,3,1,295,229,66,87.054932,sSEfF,0.034461
00:23:ae:9b:8a:bf,00:c1:b1:14:eb:31,192.168.10.16,51028,63.251.88.56,443,6,0.028092,6,3,3,449,251,198,177.986618,sSEfF,0.028092
00:23:ae:9b:8a:bf,00:c1:b1:14:eb:31,192.168.10.16,34874,34.198.161.87,443,6,0.153150,8,5,3,572,343,229,45.706821,sSEfFR,0.153150
b8:ac:6f:1d:1f:6c,00:c1:b1:14:eb:31,192.168.10.9,63882,172.217.7.14,80,6,0.036660,2,1,1,126,60,66,27.277687,sSE,0.036660
b8:ac:6f:36:08:f5,00:c1:b1:14:eb:31,192.168.10.8,49425,52.39.237.157,443,6,1.205217,22,11,11,13644,2965,10679,17.424248,sSE,1.205217
b8:ac:6f:36:08:f5,18:66:da:9b:e3:7d,192.168.10.8,54008,192.168.10.3,53,17,0.000302,4,2,2,588,246,342,9933.774414,CON,0.000302
b8:ac:6f:36:08:f5,18:66:da:9b:e3:7d,192.168.10.8,53833,192.168.10.3,53,17,0.030999,4,2,2,648,246,402,96.777321,CON,0.030999
18:66:da:9b:e3:7d,00:c1:b1:14:eb:31,192.168.10.3,60152,192.168.10.1,53,17,0.030532,2,1,1,346,134,212,32.752522,CON,0.030532
00:19:b9:0a:69:f1,00:c1:b1:14:eb:31,192.168.10.50,123,24.86.68.24,123,17,0.105475,2,1,1,180,90,90,9.480920,CON,0.105475
00:19:b9:0a:69:f1,00:c1:b1:14:eb:31,192.168.10.50,123,144.217.164.10,123,17,0.016332,2,1,1,180,90,90,61.229485,CON,0.016332
00:23:ae:9b:8a:bf,00:c1:b1:14:eb:31,192.168.10.16,58482,50.116.194.23,443,6,0.051717,6,3,3,449,198,251,96.680016,sSEfF,0.051717
00:23:ae:9b:ad:b3,18:66:da:9b:e3:7d,192.168.10.19,,192.168.10.3,,2054,0.000015,4,2,2,240,120,120,200000.000000,CON,0.000015
b8:ac:6f:36:08:f5,18:66:da:9b:e3:7d,192.168.10.8,63082,192.168.10.3,53,17,0.030972,4,2,2,308,138,170,96.861679,CON,0.030972
18:66:da:9b:e3:7d,00:c1:b1:14:eb:31,192.168.10.3,61888,192.168.10.1,53,17,0.030937,2,1,1,176,80,96,32.323757,CON,0.030937
00:c1:b1:14:eb:31,b8:ac:6f:1d:1f:6c,198.54.12.145,443,192.168.10.9,63081,6,0.000000,2,1,1,120,60,60,0.000000,E,0.000000
b8:ac:6f:36:08:f5,00:c1:b1:14:eb:31,192.168.10.8,49426,223.165.30.126,80,6,1.125802,48,20,28,40811,1513,39298,41.748016,sSE,1.125802
b8:ac:6f:36:08:f5,18:66:da:9b:e3:7d,192.168.10.8,59502,192.168.10.3,53,17,0.000012,4,2,2,308,138,170,249999.984375,CON,0.000012
b8:ac:6f:36:08:f5,18:66:da:9b:e3:7d,192.168.10.8,57169,192.168.10.3,53,17,0.031920,4,2,2,442,138,304,93.984962,CON,0.031920
18:66:da:9b:e3:7d,00:c1:b1:14:eb:31,192.168.10.3,61520,192.168.10.1,53,17,0.031561,2,1,1,243,80,163,31.684675,CON,0.031561
b8:ac:6f:36:08:f5,00:c1:b1:14:eb:31,192.168.10.8,49427,223.165.30.126,80,6,0.229171,3,2,1,188,126,62,8.727108,sSE,0.229171
b8:ac:6f:36:08:f5,18:66:da:9b:e3:7d,192.168.10.8,62557,192.168.10.3,53,17,0.000064,4,2,2,402,166,236,46875.000000,CON,0.000064
b8:ac:6f:36:08:f5,00:c1:b1:14:eb:31,192.168.10.8,49428,172.217.3.110,443,6,1.409143,47,19,28,18181,10735,7446,32.643955,sSE,1.409143
b8:ac:6f:36:08:f5,18:66:da:9b:e3:7d,192.168.10.8,49852,192.168.10.3,53,17,0.000056,4,2,2,332,150,182,53571.429688,CON,0.000056
b8:ac:6f:36:08:f5,18:66:da:9b:e3:7d,192.168.10.8,63306,192.168.10.3,53,17,0.000170,4,2,2,356,150,206,17647.058594,CON,0.000170
b8:ac:6f:36:08:f5,18:66:da:9b:e3:7d,192.168.10.8,50806,192.168.10.3,53,17,0.687156,4,2,2,714,190,524,4.365821,CON,0.687156
18:66:da:9b:e3:7d,00:c1:b1:14:eb:31,192.168.10.3,61106,192.168.10.1,53,17,0.686613,2,1,1,379,106,273,1.456424,CON,0.686613
00:23:ae:9b:8a:bf,00:c1:b1:14:eb:31,192.168.10.16,43428,198.51.152.179,443,6,0.023691,5,2,3,325,120,205,168.840485,sSEfF,0.023691
b8:ac:6f:36:0b:a8,00:c1:b1:14:eb:31,192.168.10.51,36603,162.213.33.44,443,6,1.374572,22,10,12,6121,1371,4750,15.277482,sSEfF,1.374572
b8:ac:6f:36:08:f5,00:c1:b1:14:eb:31,192.168.10.8,49429,223.165.30.126,80,6,0.233725,3,2,1,188,126,62,8.557065,sSE,0.233725
b8:ac:6f:36:08:f5,18:66:da:9b:e3:7d,192.168.10.8,56357,192.168.10.3,53,17,0.000245,4,2,2,396,158,238,12244.897461,CON,0.000245
b8:ac:6f:36:08:f5,00:c1:b1:14:eb:31,192.168.10.8,49430,172.217.10.142,80,6,1.388024,13,8,5,4293,1767,2526,8.645384,sSE,1.388024
b8:ac:6f:36:08:f5,18:66:da:9b:e3:7d,192.168.10.8,56279,192.168.10.3,53,17,0.000035,4,2,2,352,160,192,85714.281250,CON,0.000035
b8:ac:6f:36:08:f5,18:66:da:9b:e3:7d,192.168.10.8,56183,192.168.10.3,53,17,0.000153,4,2,2,376,160,216,19607.843750,CON,0.000153
b8:ac:6f:1d:1f:6c,00:c1:b1:14:eb:31,192.168.10.9,63982,72.21.81.64,80,6,0.023650,2,1,1,126,60,66,42.283298,sSE,0.023650
b8:ac:6f:1d:1f:6c,00:c1:b1:14:eb:31,192.168.10.9,63886,172.217.10.226,80,6,0.037134,2,1,1,126,60,66,26.929499,sSE,0.037134
b8:ac:6f:1d:1f:6c,00:c1:b1:14:eb:31,192.168.10.9,64045,23.194.180.170,80,6,0.025547,4,2,2,240,120,120,117.430618,sSEf,0.025547
00:23:ae:9b:8a:bf,00:c1:b1:14:eb:31,192.168.10.16,47284,104.88.32.234,443,6,0.023122,2,1,1,132,66,66,43.248856,sSE,0.023122
b8:ac:6f:1d:1f:6c,00:c1:b1:14:eb:31,192.168.10.9,64016,52.9.83.130,80,6,0.088145,2,1,1,126,60,66,11.344943,sSE,0.088145
00:23:ae:9b:ad:b3,00:c1:b1:14:eb:31,192.168.10.19,123,144.217.240.204,123,17,0.016136,2,1,1,180,90,90,61.973228,CON,0.016136
b8:ac:6f:1d:1f:6c,00:c1:b1:14:eb:31,192.168.10.9,64046,34.202.69.17,80,6,0.052187,4,2,2,240,120,120,57.485580,sSEfF,0.052187
b8:ac:6f:1d:1f:6c,00:c1:b1:14:eb:31,192.168.10.9,63213,23.194.108.16,443,6,0.024320,2,1,1,126,60,66,41.118420,E,0.024320
b8:ac:6f:1d:1f:6c,00:c1:b1:14:eb:31,192.168.10.9,64047,162.208.20.178,80,6,0.085626,4,2,2,240,120,120,35.036087,sSEfF,0.085626
00:1e:4f:d4:ca:28,00:c1:b1:14:eb:31,192.168.10.15,50445,104.28.17.9,443,6,0.065864,3,2,1,260,160,100,30.365602,sSE,0.065864
b8:ac:6f:1d:1f:6c,00:c1:b1:14:eb:31,192.168.10.9,64048,162.208.20.178,80,6,0.084867,4,2,2,240,120,120,35.349430,sSEfF,0.084867
b8:ac:6f:1d:1f:6c,00:c1:b1:14:eb:31,192.168.10.9,64018,52.9.151.139,80,6,0.087810,2,1,1,126,60,66,11.388225,sSE,0.087810
00:23:ae:9b:8a:bf,00:c1:b1:14:eb:31,192.168.10.16,56736,52.84.30.244,443,6,0.031209,2,1,1,132,66,66,32.042038,sSE,0.031209
00:23:ae:9b:8a:bf,00:c1:b1:14:eb:31,192.168.10.16,57772,23.50.75.27,80,6,0.023172,3,2,1,198,132,66,86.311066,sSEf,0.023172
00:23:ae:9b:8a:bf,00:c1:b1:14:eb:31,192.168.10.16,48984,208.185.118.91,80,6,0.028060,3,2,1,198,132,66,71.275833,sSEf,0.028060
00:23:ae:9b:8a:bf,00:c1:b1:14:eb:31,192.168.10.16,59634,192.243.232.58,443,6,0.102357,5,3,2,347,227,120,39.078911,sSEfF,0.102357
b8:ac:6f:36:08:f5,18:66:da:9b:e3:7d,192.168.10.8,57002,192.168.10.3,53,17,0.000238,4,2,2,458,178,280,12605.041992,CON,0.000238
b8:ac:6f:36:08:f5,00:c1:b1:14:eb:31,192.168.10.8,49431,216.58.217.142,443,6,0.392921,49,21,28,13750,2731,11019,122.161964,sSE,0.392921
b8:ac:6f:36:08:f5,18:66:da:9b:e3:7d,192.168.10.8,62693,192.168.10.3,53,17,0.000007,4,2,2,396,182,214,428571.437500,CON,0.000007
b8:ac:6f:36:08:f5,18:66:da:9b:e3:7d,192.168.10.8,61876,192.168.10.3,53,17,0.031633,4,2,2,420,182,238,94.837669,CON,0.031633
18:66:da:9b:e3:7d,00:c1:b1:14:eb:31,192.168.10.3,61652,192.168.10.1,53,17,0.031209,2,1,1,232,102,130,32.042038,CON,0.031209
b8:ac:6f:36:08:f5,00:c1:b1:14:eb:31,192.168.10.8,49432,54.192.37.122,443,6,5.030396,14,8,6,4893,841,4052,2.584290,sSEf,5.030396
b8:ac:6f:36:08:f5,18:66:da:9b:e3:7d,192.168.10.8,49418,192.168.10.3,53,17,0.001009,4,2,2,714,190,524,2973.240723,CON,0.001009
18:66:da:9b:e3:7d,00:c1:b1:14:eb:31,192.168.10.3,62525,192.168.10.1,53,17,0.000473,2,1,1,379,106,273,2114.165039,CON,0.000473
b8:ac:6f:36:08:f5,18:66:da:9b:e3:7d,192.168.10.8,62353,192.168.10.3,53,17,0.000052,4,2,2,608,176,432,57692.308594,CON,0.000052
b8:ac:6f:36:08:f5,18:66:da:9b:e3:7d,192.168.10.8,60392,192.168.10.3,53,17,0.030760,4,2,2,514,176,338,97.529259,CON,0.030760
18:66:da:9b:e3:7d,00:c1:b1:14:eb:31,192.168.10.3,61012,192.168.10.1,53,17,0.030530,2,1,1,279,99,180,32.754669,CON,0.030530
b8:ac:6f:1d:1f:6c,00:c1:b1:14:eb:31,192.168.10.9,63899,69.169.86.38,443,6,0.022888,2,1,1,120,60,60,43.691017,sSE,0.022888
b8:ac:6f:36:08:f5,18:66:da:9b:e3:7d,192.168.10.8,62140,192.168.10.3,53,17,0.000017,4,2,2,456,168,288,176470.578125,CON,0.000017
b8:ac:6f:36:08:f5,00:c1:b1:14:eb:31,192.168.10.8,49433,172.217.3.110,443,6,0.195819,20,10,10,5831,1091,4740,97.028374,sSEfR,0.195819
b8:ac:6f:36:08:f5,18:66:da:9b:e3:7d,192.168.10.8,53768,192.168.10.3,53,17,0.000163,4,2,2,404,186,218,18404.908203,CON,0.000163
b8:ac:6f:36:08:f5,18:66:da:9b:e3:7d,192.168.10.8,57193,192.168.10.3,53,17,0.000013,4,2,2,428,186,242,230769.234375,CON,0.000013
b8:ac:6f:36:08:f5,18:66:da:9b:e3:7d,192.168.10.8,52917,192.168.10.3,53,17,0.060870,4,2,2,432,158,274,49.285362,CON,0.060870
18:66:da:9b:e3:7d,00:c1:b1:14:eb:31,192.168.10.3,60840,192.168.10.1,53,17,0.060438,2,1,1,238,90,148,16.545881,CON,0.060438
00:c1:b1:14:eb:31,b8:ac:6f:1d:1f:6c,192.35.249.124,80,192.168.10.9,63033,6,1.589846,21,13,8,11346,9412,1934,12.579835,E,1.589846
00:23:ae:9b:8a:bf,00:c1:b1:14:eb:31,192.168.10.16,37508,54.192.37.225,443,6,0.030994,2,1,1,132,66,66,32.264309,sSE,0.030994
b8:ac:6f:36:08:f5,00:c1:b1:14:eb:31,192.168.10.8,49434,54.192.39.67,80,6,0.062782,9,4,5,3748,534,3214,127.425064,sSE,0.062782
b8:ac:6f:36:08:f5,00:c1:b1:14:eb:31,192.168.10.8,49435,54.192.39.67,80,6,1.028333,5,3,2,324,192,132,3.889791,sSE,1.028333
b8:ac:6f:36:08:f5,18:66:da:9b:e3:7d,192.168.10.8,53172,192.168.10.3,53,17,0.000158,4,2,2,384,176,208,18987.341797,CON,0.000158
b8:ac:6f:36:08:f5,18:66:da:9b:e3:7d,192.168.10.8,63181,192.168.10.3,53,17,0.030878,4,2,2,522,176,346,97.156555,CON,0.030878
18:66:da:9b:e3:7d,00:c1:b1:14:eb:31,192.168.10.3,61273,192.168.10.1,53,17,0.030490,2,1,1,283,99,184,32.797638,CON,0.030490
00:1e:4f:d4:ca:28,00:c1:b1:14:eb:31,192.168.10.15,50463,38.65.9.35,443,6,0.037053,5,3,2,325,205,120,107.953468,sSEfF,0.037053
00:1e:4f:d4:ca:28,00:c1:b1:14:eb:31,192.168.10.15,50467,38.65.9.35,443,6,0.037797,5,3,2,325,205,120,105.828506,sSEfF,0.037797
00:1e:4f:d4:ca:28,00:c1:b1:14:eb:31,192.168.10.15,50462,23.194.141.229,443,6,0.023934,6,3,3,410,205,205,208.907837,sSEfR,0.023934
00:1e:4f:d4:ca:28,00:c1:b1:14:eb:31,192.168.10.15,50468,38.65.9.35,443,6,0.038438,5,3,2,325,205,120,104.063690,sSEfF,0.038438
00:1e:4f:d4:ca:28,00:c1:b1:14:eb:31,192.168.10.15,50466,38.65.9.35,443,6,0.037628,5,3,2,325,205,120,106.303818,sSEfF,0.037628
b8:ac:6f:1d:1f:6c,00:c1:b1:14:eb:31,192.168.10.9,63119,74.121.138.156,443,6,0.023870,2,1,1,126,60,66,41.893589,E,0.023870
b8:ac:6f:36:08:f5,00:c1:b1:14:eb:31,192.168.10.8,49418,35.160.100.86,443,6,0.084650,2,1,1,126,60,66,11.813349,sSE,0.084650
b8:ac:6f:36:08:f5,18:66:da:9b:e3:7d,192.168.10.8,61464,192.168.10.3,53,17,0.000216,4,2,2,504,166,338,13888.888672,CON,0.000216
b8:ac:6f:36:08:f5,00:c1:b1:14:eb:31,192.168.10.8,49436,74.125.22.157,443,6,0.270340,25,11,14,6972,1596,5376,88.777100,sSE,0.270340
b8:ac:6f:36:08:f5,18:66:da:9b:e3:7d,192.168.10.8,50413,192.168.10.3,53,17,0.000015,4,2,2,460,166,294,200000.000000,CON,0.000015
b8:ac:6f:36:08:f5,18:66:da:9b:e3:7d,192.168.10.8,50095,192.168.10.3,53,17,0.000163,4,2,2,388,166,222,18404.908203,CON,0.000163
b8:ac:6f:36:08:f5,18:66:da:9b:e3:7d,192.168.10.8,64095,192.168.10.3,53,17,0.091077,4,2,2,502,152,350,32.939163,CON,0.091077
18:66:da:9b:e3:7d,00:c1:b1:14:eb:31,192.168.10.3,61957,192.168.10.1,53,17,0.090631,2,1,1,273,87,186,11.033752,CON,0.090631
b8:ac:6f:1d:1f:6c,00:c1:b1:14:eb:31,192.168.10.9,64049,162.208.20.178,80,6,0.084857,3,2,1,180,120,60,23.569063,sSEf,0.084857
b8:ac:6f:1d:1f:6c,00:c1:b1:14:eb:31,192.168.10.9,64053,23.194.180.170,80,6,0.023484,3,2,1,180,120,60,85.164368,sSEf,0.023484
b8:ac:6f:1d:1f:6c,00:c1:b1:14:eb:31,192.168.10.9,64057,52.1.14.213,80,6,0.051028,3,2,1,180,120,60,39.194168,sSEf,0.051028
b8:ac:6f:1d:1f:6c,00:c1:b1:14:eb:31,192.168.10.9,64055,156.154.200.36,80,6,0.033681,4,2,2,240,120,120,89.070984,sSEf,0.033681
b8:ac:6f:1d:1f:6c,00:c1:b1:14:eb:31,192.168.10.9,64050,162.208.20.178,80,6,0.085212,3,2,1,180,120,60,23.470873,sSEf,0.085212
00:23:ae:9b:8a:bf,00:c1:b1:14:eb:31,192.168.10.16,48804,23.194.108.111,443,6,0.024644,2,1,1,132,66,66,40.577827,sSE,0.024644
b8:ac:6f:36:08:f5,18:66:da:9b:e3:7d,192.168.10.8,59802,192.168.10.3,53,17,0.061248,4,2,2,520,158,362,48.981190,CON,0.061248
18:66:da:9b:e3:7d,00:c1:b1:14:eb:31,192.168.10.3,60690,192.168.10.1,53,17,0.060940,2,1,1,282,90,192,16.409582,CON,0.060940
b8:ac:6f:36:08:f5,18:66:da:9b:e3:7d,192.168.10.8,65318,192.168.10.3,53,17,0.000063,4,2,2,380,174,206,47619.046875,CON,0.000063
b8:ac:6f:36:08:f5,18:66:da:9b:e3:7d,192.168.10.8,54464,192.168.10.3,53,17,0.031478,4,2,2,460,174,286,95.304657,CON,0.031478
18:66:da:9b:e3:7d,00:c1:b1:14:eb:31,192.168.10.3,61282,192.168.10.1,53,17,0.031174,2,1,1,252,98,154,32.078014,CON,0.031174
b8:ac:6f:36:08:f5,00:c1:b1:14:eb:31,192.168.10.8,49437,23.203.74.20,80,6,0.250275,8,5,3,2073,590,1483,27.969234,sSE,0.250275
b8:ac:6f:36:08:f5,00:c1:b1:14:eb:31,192.168.10.8,49438,23.203.74.20,80,6,0.023575,3,2,1,192,126,66,84.835632,sSE,0.023575
b8:ac:6f:36:08:f5,00:c1:b1:14:eb:31,192.168.10.8,49439,23.203.74.20,80,6,0.060136,6,4,2,665,539,126,83.144867,sSE,0.060136
b8:ac:6f:1d:1f:6c,00:c1:b1:14:eb:31,192.168.10.9,63904,152.163.56.2,443,6,0.028282,2,1,1,120,60,60,35.358177,sSE,0.028282
b8:ac:6f:36:08:f5,00:c1:b1:14:eb:31,192.168.10.8,49440,23.203.74.20,80,6,0.023331,3,2,1,192,126,66,85.722862,sSE,0.023331
b8:ac:6f:36:08:f5,00:c1:b1:14:eb:31,192.168.10.8,49441,23.203.74.20,80,6,0.023368,3,2,1,192,126,66,85.587128,sSE,0.023368
b8:ac:6f:36:08:f5,00:c1:b1:14:eb:31,192.168.10.8,49442,23.203.74.20,80,6,0.553762,46,25,21,28712,2089,26623,81.262344,sSE,0.553762
00:23:ae:9b:8a:bf,00:c1:b1:14:eb:31,192.168.10.16,60516,96.16.195.81,443,6,0.023622,2,1,1,132,66,66,42.333416,sSE,0.023622
b8:ac:6f:1d:1f:6c,00:c1:b1:14:eb:31,192.168.10.9,63616,184.31.6.135,443,6,0.028634,2,1,1,126,60,66,34.923515,E,0.028634
00:23:ae:9b:8a:bf,00:c1:b1:14:eb:31,192.168.10.16,59752,34.205.88.17,443,6,0.051386,5,3,2,361,198,163,77.842216,sSEfF,0.051386
00:23:ae:9b:8a:bf,00:c1:b1:14:eb:31,192.168.10.16,37528,54.192.37.225,443,6,0.032066,2,1,1,132,66,66,31.185680,sSE,0.032066
00:23:ae:9b:95:67,00:c1:b1:14:eb:31,192.168.10.17,42290,104.24.11.59,443,6,0.014948,3,2,1,180,120,60,133.797165,sSEfF,0.014948
00:23:ae:9b:95:67,00:c1:b1:14:eb:31,192.168.10.17,40554,104.19.196.102,443,6,0.015131,3,2,1,180,120,60,132.178970,sSEfF,0.015131
00:23:ae:9b:95:67,00:c1:b1:14:eb:31,192.168.10.17,52830,104.24.11.59,80,6,0.015127,3,2,1,180,120,60,132.213913,sSEfF,0.015127
00:23:ae:9b:95:67,00:c1:b1:14:eb:31,192.168.10.17,49063,151.101.20.193,80,6,0.023193,3,2,1,198,132,66,86.232918,sSEfF,0.023193
00:23:ae:9b:95:67,00:c1:b1:14:eb:31,192.168.10.17,38300,192.0.76.3,443,6,0.024042,3,2,1,180,120,60,83.187759,sSEfF,0.024042
00:23:ae:9b:95:67,00:c1:b1:14:eb:31,192.168.10.17,33921,192.0.77.32,443,6,0.024041,3,2,1,180,120,60,83.191216,sSEfF,0.024041
00:23:ae:9b:95:67,00:c1:b1:14:eb:31,192.168.10.17,51373,172.217.3.110,443,6,0.036892,3,2,1,198,132,66,54.212296,sSEfF,0.036892
00:23:ae:9b:95:67,00:c1:b1:14:eb:31,192.168.10.17,45144,72.21.91.29,80,6,0.023669,3,2,1,198,132,66,84.498711,sSEfF,0.023669
00:23:ae:9b:95:67,00:c1:b1:14:eb:31,192.168.10.17,37119,54.192.36.124,443,6,0.029381,3,2,1,198,132,66,68.071205,sSEfF,0.029381
00:23:ae:9b:95:67,00:c1:b1:14:eb:31,192.168.10.17,55194,23.50.75.27,80,6,0.023021,3,2,1,198,132,66,86.877197,sSEfF,0.023021
00:23:ae:9b:95:67,00:c1:b1:14:eb:31,192.168.10.17,36811,54.192.36.14,443,6,0.030825,3,2,1,198,132,66,64.882401,sSEfF,0.030825
00:23:ae:9b:95:67,00:c1:b1:14:eb:31,192.168.10.17,44913,74.125.22.156,443,6,0.049452,3,2,1,198,132,66,40.443260,sSEfF,0.049452
00:23:ae:9b:95:67,00:c1:b1:14:eb:31,192.168.10.17,38288,192.0.76.3,443,6,0.024020,3,2,1,180,120,60,83.263947,sSEfF,0.024020
00:23:ae:9b:95:67,00:c1:b1:14:eb:31,192.168.10.17,55201,23.50.75.27,80,6,0.023166,3,2,1,198,132,66,86.333420,sSEfF,0.023166
00:23:ae:9b:95:67,00:c1:b1:14:eb:31,192.168.10.17,59967,54.192.37.81,443,6,0.031324,3,2,1,198,132,66,63.848808,sSEfF,0.031324
00:23:ae:9b:8a:bf,00:c1:b1:14:eb:31,192.168.10.16,45398,98.139.225.43,443,6,0.024765,4,3,1,295,229,66,121.138702,sSEfF,0.024765
00:23:ae:9b:8a:bf,00:c1:b1:14:eb:31,192.168.10.16,51690,173.241.242.143,443,6,3.708852,18,10,8,2329,625,1704,4.583629,sSEfFR,3.708852
00:23:ae:9b:8a:bf,00:c1:b1:14:eb:31,192.168.10.16,48502,8.39.37.45,443,6,0.087517,4,3,1,287,227,60,34.279053,sSEfF,0.087517
00:23:ae:9b:8a:bf,00:c1:b1:14:eb:31,192.168.10.16,47094,192.82.242.50,443,6,0.023917,5,3,2,331,211,120,167.245056,sSEfF,0.023917
00:23:ae:9b:8a:bf,00:c1:b1:14:eb:31,192.168.10.16,48506,8.39.37.45,443,6,0.087526,4,3,1,287,227,60,34.275528,sSEfF,0.087526
00:19:b9:0a:69:f1,00:c1:b1:14:eb:31,192.168.10.50,123,4.53.160.75,123,17,0.040424,2,1,1,180,90,90,24.737780,CON,0.040424
00:23:ae:9b:8a:bf,00:c1:b1:14:eb:31,192.168.10.16,42944,50.17.246.138,443,6,0.050407,2,1,1,132,66,66,19.838514,sSE,0.050407
00:1e:4f:d4:ca:28,00:c1:b1:14:eb:31,192.168.10.15,50244,52.84.40.136,80,6,0.031753,3,2,1,180,120,60,62.986176,sSEfF,0.031753
b8:ac:6f:36:08:f5,18:66:da:9b:e3:7d,192.168.10.8,52826,192.168.10.3,53,17,0.061230,4,2,2,398,162,236,48.995590,CON,0.061230
18:66:da:9b:e3:7d,00:c1:b1:14:eb:31,192.168.10.3,61456,192.168.10.1,53,17,0.060775,2,1,1,221,92,129,16.454134,CON,0.060775
b8:ac:6f:36:08:f5,18:66:da:9b:e3:7d,192.168.10.8,64423,192.168.10.3,53,17,0.000223,4,2,2,482,172,310,13452.915039,CON,0.000223
b8:ac:6f:36:08:f5,18:66:da:9b:e3:7d,192.168.10.8,50844,192.168.10.3,53,17,0.000176,4,2,2,426,174,252,17045.455078,CON,0.000176
b8:ac:6f:36:08:f5,00:c1:b1:14:eb:31,192.168.10.8,49443,52.216.1.208,443,6,0.223709,18,9,9,2610,1171,1439,75.991577,sSE,0.223709
b8:ac:6f:36:08:f5,00:c1:b1:14:eb:31,192.168.10.8,49444,52.216.1.208,443,6,0.196789,20,9,11,5237,1171,4066,96.550117,sSE,0.196789
b8:ac:6f:36:08:f5,18:66:da:9b:e3:7d,192.168.10.8,63507,192.168.10.3,53,17,0.000158,4,2,2,352,160,192,18987.341797,CON,0.000158
b8:ac:6f:36:08:f5,18:66:da:9b:e3:7d,192.168.10.8,52801,192.168.10.3,53,17,0.000242,4,2,2,482,160,322,12396.694336,CON,0.000242
b8:ac:6f:36:08:f5,18:66:da:9b:e3:7d,192.168.10.8,60891,192.168.10.3,53,17,0.030948,4,2,2,488,174,314,96.936798,CON,0.030948
b8:ac:6f:36:08:f5,18:66:da:9b:e3:7d,192.168.10.8,51749,192.168.10.3,53,17,0.031535,4,2,2,456,172,284,95.132393,CON,0.031535
18:66:da:9b:e3:7d,00:c1:b1:14:eb:31,192.168.10.3,62372,192.168.10.1,53,17,0.030538,2,1,1,294,98,196,32.746086,CON,0.030538
18:66:da:9b:e3:7d,00:c1:b1:14:eb:31,192.168.10.3,60512,192.168.10.1,53,17,0.031191,2,1,1,250,97,153,32.060528,CON,0.031191
b8:ac:6f:36:08:f5,18:66:da:9b:e3:7d,192.168.10.8,61877,192.168.10.3,53,17,0.000171,4,2,2,450,170,280,17543.859375,CON,0.000171
b8:ac:6f:1d:1f:6c,00:c1:b1:14:eb:31,192.168.10.9,63911,52.22.157.218,443,6,0.050087,2,1,1,120,60,60,19.965260,sSE,0.050087
b8:ac:6f:36:08:f5,00:c1:b1:14:eb:31,192.168.10.8,49445,52.216.1.208,443,6,0.158254,14,7,7,1628,742,886,82.146423,sSE,0.158254
b8:ac:6f:36:08:f5,00:c1:b1:14:eb:31,192.168.10.8,49446,72.21.91.29,80,6,0.023704,3,2,1,192,126,66,84.373947,sSE,0.023704
b8:ac:6f:1d:1f:6c,00:c1:b1:14:eb:31,192.168.10.9,63912,199.38.164.157,443,6,0.023008,2,1,1,120,60,60,43.463142,sSE,0.023008
00:23:ae:9b:8a:bf,00:c1:b1:14:eb:31,192.168.10.16,46166,72.247.66.125,443,6,0.023560,2,1,1,132,66,66,42.444820,sSE,0.023560
b8:ac:6f:36:0a:8b,00:c1:b1:14:eb:31,192.168.10.5,52087,151.101.0.166,443,6,0.015013,2,1,1,126,60,66,66.608940,sSE,0.015013
b8:ac:6f:36:0a:8b,00:c1:b1:14:eb:31,192.168.10.5,52124,151.101.0.166,443,6,0.015249,2,1,1,126,60,66,65.578072,sSE,0.015249
00:23:ae:9b:8a:bf,00:c1:b1:14:eb:31,192.168.10.16,36558,52.205.102.17,443,6,0.050223,2,1,1,132,66,66,19.911196,sSE,0.050223
b8:ac:6f:1d:1f:6c,18:66:da:9b:e3:7d,192.168.10.9,60880,192.168.10.3,53,17,0.031042,4,2,2,486,152,334,96.643257,CON,0.031042
b8:ac:6f:1d:1f:6c,18:66:da:9b:e3:7d,192.168.10.9,53645,192.168.10.3,53,17,0.030832,4,2,2,486,152,334,97.301506,CON,0.030832
18:66:da:9b:e3:7d,00:c1:b1:14:eb:31,192.168.10.3,60507,192.168.10.1,53,17,0.030594,2,1,1,202,93,109,32.686146,CON,0.030594
b8:ac:6f:1d:1f:6c,00:c1:b1:14:eb:31,192.168.10.9,64058,23.194.108.45,80,6,0.024026,3,2,1,192,126,66,83.243149,sSE,0.024026
b8:ac:6f:1d:1f:6c,18:66:da:9b:e3:7d,192.168.10.9,53971,192.168.10.3,53,17,0.000191,4,2,2,486,152,334,15706.806641,CON,0.000191
b8:ac:6f:1d:1f:6c,18:66:da:9b:e3:7d,192.168.10.9,53281,192.168.10.3,53,17,0.000091,4,2,2,360,164,196,32967.031250,CON,0.000091
b8:ac:6f:1d:1f:6c,18:66:da:9b:e3:7d,192.168.10.9,49303,192.168.10.3,53,17,0.000250,4,2,2,360,164,196,11999.999023,CON,0.000250
00:c1:b1:14:eb:31,b8:ac:6f:1d:1f:6c,198.54.12.145,80,192.168.10.9,63038,6,0.197353,5,3,2,1988,414,1574,20.268250,E,0.197353
b8:ac:6f:1d:1f:6c,00:c1:b1:14:eb:31,192.168.10.9,64059,34.202.69.17,80,6,0.357310,9,5,4,1413,637,776,22.389523,sSE,0.357310
b8:ac:6f:1d:1f:6c,00:c1:b1:14:eb:31,192.168.10.9,63260,198.54.12.111,80,6,0.381862,7,3,4,2126,1166,960,15.712481,E,0.381862
b8:ac:6f:1d:1f:6c,18:66:da:9b:e3:7d,192.168.10.9,57496,192.168.10.3,53,17,0.030976,4,2,2,414,168,246,96.849174,CON,0.030976
b8:ac:6f:1d:1f:6c,18:66:da:9b:e3:7d,192.168.10.9,52888,192.168.10.3,53,17,0.030800,4,2,2,414,168,246,97.402596,CON,0.030800
18:66:da:9b:e3:7d,00:c1:b1:14:eb:31,192.168.10.3,61039,192.168.10.1,53,17,0.030502,2,1,1,194,89,105,32.784733,CON,0.030502
b8:ac:6f:1d:1f:6c,18:66:da:9b:e3:7d,192.168.10.9,60627,192.168.10.3,53,17,0.026809,4,2,2,414,168,246,111.902725,CON,0.026809
18:66:da:9b:e3:7d,00:c1:b1:14:eb:31,192.168.10.3,61092,192.168.10.1,53,17,0.026356,2,1,1,194,89,105,37.942024,CON,0.026356
b8:ac:6f:1d:1f:6c,18:66:da:9b:e3:7d,192.168.10.9,62146,192.168.10.3,53,17,0.026551,4,2,2,414,168,246,112.990089,CON,0.026551
b8:ac:6f:1d:1f:6c,00:c1:b1:14:eb:31,192.168.10.9,63948,172.217.10.226,80,6,0.037298,2,1,1,126,60,66,26.811089,sSE,0.037298
b8:ac:6f:1d:1f:6c,00:c1:b1:14:eb:31,192.168.10.9,64060,162.208.22.34,80,6,5.082139,12,7,5,2201,817,1384,2.164443,sSEfF,5.082139
b8:ac:6f:1d:1f:6c,18:66:da:9b:e3:7d,192.168.10.9,58085,192.168.10.3,53,17,0.000185,4,2,2,414,168,246,16216.216797,CON,0.000185
b8:ac:6f:1d:1f:6c,00:c1:b1:14:eb:31,192.168.10.9,64061,162.208.22.34,80,6,5.087799,12,7,5,2201,817,1384,2.162035,sSEfF,5.087799
b8:ac:6f:1d:1f:6c,18:66:da:9b:e3:7d,192.168.10.9,52486,192.168.10.3,53,17,0.000262,4,2,2,414,168,246,11450.381836,CON,0.000262
b8:ac:6f:1d:1f:6c,18:66:da:9b:e3:7d,192.168.10.9,57057,192.168.10.3,53,17,0.000145,4,2,2,344,156,188,20689.656250,CON,0.000145
b8:ac:6f:1d:1f:6c,18:66:da:9b:e3:7d,192.168.10.9,52990,192.168.10.3,53,17,0.000210,4,2,2,344,156,188,14285.714844,CON,0.000210
b8:ac:6f:1d:1f:6c,18:66:da:9b:e3:7d,192.168.10.9,50808,192.168.10.3,53,17,0.000170,4,2,2,344,156,188,17647.058594,CON,0.000170
70:6e:6d:1d:bb:08,01:00:0c:cc:cc:cc,01:00:0c:cc:cc:cc,170,70:6e:6d:1d:bb:08,170,0,0.000000,1,1,0,457,457,0,0.000000,INT,0.000000
00:c1:b1:14:eb:31,b8:ac:6f:1d:1f:6c,198.54.12.145,80,192.168.10.9,63044,6,0.291376,4,3,1,452,392,60,10.295975,E,0.291376
b8:ac:6f:1d:1f:6c,00:c1:b1:14:eb:31,192.168.10.9,64062,162.208.22.34,80,6,0.041281,3,2,1,192,126,66,48.448441,sSE,0.041281
b8:ac:6f:1d:1f:6c,00:c1:b1:14:eb:31,192.168.10.9,64063,162.208.22.34,80,6,0.039003,3,2,1,192,126,66,51.278107,sSE,0.039003
b8:ac:6f:1d:1f:6c,00:c1:b1:14:eb:31,192.168.10.9,63998,199.233.57.18,80,6,0.232447,3,2,1,1911,867,1044,8.604112,sSE,0.232447
00:c1:b1:14:eb:31,b8:ac:6f:1d:1f:6c,198.54.12.145,80,192.168.10.9,63045,6,0.287132,4,3,1,478,418,60,10.448156,E,0.287132
00:c1:b1:14:eb:31,b8:ac:6f:1d:1f:6c,52.3.119.216,80,192.168.10.9,63072,6,0.408871,5,2,3,5621,2971,2650,9.783037,E,0.408871
b8:ac:6f:1d:1f:6c,18:66:da:9b:e3:7d,192.168.10.9,61765,192.168.10.3,53,17,0.031026,4,2,2,560,166,394,96.693092,CON,0.031026
18:66:da:9b:e3:7d,00:c1:b1:14:eb:31,192.168.10.3,62347,192.168.10.1,53,17,0.030611,2,1,1,214,91,123,32.667995,CON,0.030611
b8:ac:6f:1d:1f:6c,00:c1:b1:14:eb:31,192.168.10.9,62875,172.217.10.130,80,6,0.248879,3,2,1,1457,617,840,8.036034,E,0.248879
b8:ac:6f:1d:1f:6c,18:66:da:9b:e3:7d,192.168.10.9,50882,192.168.10.3,53,17,0.031212,4,2,2,734,150,584,96.116875,CON,0.031212
18:66:da:9b:e3:7d,00:c1:b1:14:eb:31,192.168.10.3,60508,192.168.10.1,53,17,0.030724,2,1,1,368,120,248,32.547844,CON,0.030724
b8:ac:6f:1d:1f:6c,18:66:da:9b:e3:7d,192.168.10.9,50095,192.168.10.3,53,17,0.033018,4,2,2,474,172,302,90.859528,CON,0.033018
18:66:da:9b:e3:7d,00:c1:b1:14:eb:31,192.168.10.3,62535,192.168.10.1,53,17,0.032585,2,1,1,259,97,162,30.688969,CON,0.032585
b8:ac:6f:36:04:e3,00:23:ae:9b:95:67,192.168.10.12,,192.168.10.17,,2054,0.000136,4,2,2,240,120,120,22058.822266,CON,0.000136
b8:ac:6f:36:08:f5,00:c1:b1:14:eb:31,192.168.10.8,49419,72.21.91.29,80,6,0.000000,1,1,0,60,60,0,0.000000,sSE,0.000000
b8:ac:6f:1d:1f:6c,18:66:da:9b:e3:7d,192.168.10.9,53241,192.168.10.3,53,17,0.000157,4,2,2,384,160,224,19108.279297,CON,0.000157
b8:ac:6f:1d:1f:6c,18:66:da:9b:e3:7d,192.168.10.9,49905,192.168.10.3,53,17,0.000197,4,2,2,692,218,474,15228.426758,CON,0.000197
b8:ac:6f:1d:1f:6c,00:c1:b1:14:eb:31,192.168.10.9,64064,23.23.130.16,80,6,2.612347,11,6,5,1538,740,798,3.827976,sSEfF,2.612347
b8:ac:6f:1d:1f:6c,00:c1:b1:14:eb:31,192.168.10.9,64065,23.23.130.16,80,6,2.612309,7,4,3,432,246,186,2.296819,sSEf,2.612309
b8:ac:6f:1d:1f:6c,00:c1:b1:14:eb:31,192.168.10.9,63040,198.54.12.145,80,6,0.000000,3,1,2,180,60,120,0.000000,E,0.000000
b8:ac:6f:1d:1f:6c,18:66:da:9b:e3:7d,192.168.10.9,58179,192.168.10.3,53,17,0.000227,4,2,2,486,152,334,13215.859375,CON,0.000227
b8:ac:6f:1d:1f:6c,18:66:da:9b:e3:7d,192.168.10.9,63333,192.168.10.3,53,17,0.031094,4,2,2,460,166,294,96.481636,CON,0.031094
18:66:da:9b:e3:7d,00:c1:b1:14:eb:31,192.168.10.3,62264,192.168.10.1,53,17,0.030645,2,1,1,226,105,121,32.631752,CON,0.030645
b8:ac:6f:1d:1f:6c,00:c1:b1:14:eb:31,192.168.10.9,64066,23.194.108.45,80,6,0.023904,3,2,1,192,126,66,83.668007,sSE,0.023904
b8:ac:6f:1d:1f:6c,18:66:da:9b:e3:7d,192.168.10.9,53888,192.168.10.3,53,17,0.000232,4,2,2,486,152,334,12931.034180,CON,0.000232
b8:ac:6f:1d:1f:6c,18:66:da:9b:e3:7d,192.168.10.9,59047,192.168.10.3,53,17,0.000150,4,2,2,360,164,196,20000.000000,CON,0.000150
b8:ac:6f:1d:1f:6c,18:66:da:9b:e3:7d,192.168.10.9,61014,192.168.10.3,53,17,0.000244,4,2,2,486,152,334,12295.082031,CON,0.000244
b8:ac:6f:1d:1f:6c,00:c1:b1:14:eb:31,192.168.10.9,63916,104.97.103.209,443,6,0.023343,2,1,1,126,60,66,42.839394,sSE,0.023343
b8:ac:6f:1d:1f:6c,18:66:da:9b:e3:7d,192.168.10.9,50529,192.168.10.3,53,17,0.000197,4,2,2,408,188,220,15228.426758,CON,0.000197
b8:ac:6f:1d:1f:6c,00:c1:b1:14:eb:31,192.168.10.9,64067,72.30.202.150,80,6,0.276129,9,5,4,1397,641,756,28.971966,sSE,0.276129
b8:ac:6f:1d:1f:6c,00:c1:b1:14:eb:31,192.168.10.9,64068,72.30.202.150,80,6,0.025165,3,2,1,192,126,66,79.475456,sSE,0.025165
b8:ac:6f:1d:1f:6c,18:66:da:9b:e3:7d,192.168.10.9,54257,192.168.10.3,53,17,0.000149,4,2,2,516,188,328,20134.228516,CON,0.000149
b8:ac:6f:1d:1f:6c,00:c1:b1:14:eb:31,192.168.10.9,64069,208.81.233.48,80,6,0.125299,9,5,4,1745,848,897,63.847275,sSEfF,0.125299
b8:ac:6f:1d:1f:6c,00:c1:b1:14:eb:31,192.168.10.9,64070,208.81.233.48,80,6,0.040295,3,2,1,186,126,60,49.633949,sSE,0.040295
00:1e:4f:d4:ca:28,00:c1:b1:14:eb:31,192.168.10.15,50262,172.217.12.132,443,6,0.086576,3,2,1,260,160,100,23.101089,sSE,0.086576
00:1e:4f:d4:ca:28,00:c1:b1:14:eb:31,192.168.10.15,50417,172.217.12.131,443,6,0.086580,3,2,1,260,160,100,23.100023,sSE,0.086580
00:1e:4f:d4:ca:28,00:c1:b1:14:eb:31,192.168.10.15,50201,216.58.219.226,443,6,0.060451,3,2,1,260,160,100,33.084648,sSE,0.060451
b8:ac:6f:36:0b:a8,18:66:da:9b:e3:7d,192.168.10.51,45518,192.168.10.3,53,17,0.000008,4,2,2,368,152,216,375000.000000,CON,0.000008
b8:ac:6f:1d:1f:6c,00:c1:b1:14:eb:31,192.168.10.9,63908,23.194.181.179,443,6,0.023038,2,1,1,126,60,66,43.406548,sSE,0.023038
00:23:ae:9b:8a:bf,00:c1:b1:14:eb:31,192.168.10.16,43334,198.41.214.185,80,6,0.015156,2,1,1,120,60,60,65.980469,sSE,0.015156
00:23:ae:9b:8a:bf,00:c1:b1:14:eb:31,192.168.10.16,43346,198.41.214.185,80,6,0.015159,2,1,1,120,60,60,65.967415,sSE,0.015159
00:23:ae:9b:8a:bf,00:c1:b1:14:eb:31,192.168.10.16,60646,52.85.100.25,443,6,0.030854,2,1,1,132,66,66,32.410709,sSE,0.030854
b8:ac:6f:1d:1f:6c,18:66:da:9b:e3:7d,192.168.10.9,60877,192.168.10.3,53,17,0.000259,4,2,2,764,148,616,11583.011719,CON,0.000259
b8:ac:6f:1d:1f:6c,18:66:da:9b:e3:7d,192.168.10.9,52163,192.168.10.3,53,17,0.000226,4,2,2,764,148,616,13274.335938,CON,0.000226
b8:ac:6f:1d:1f:6c,18:66:da:9b:e3:7d,192.168.10.9,49329,192.168.10.3,53,17,0.000252,4,2,2,696,220,476,11904.761719,CON,0.000252
00:23:ae:9b:8a:bf,00:c1:b1:14:eb:31,192.168.10.16,47134,192.82.242.50,443,6,0.023825,5,3,2,331,211,120,167.890884,sSEfF,0.023825
00:23:ae:9b:8a:bf,00:c1:b1:14:eb:31,192.168.10.16,35064,54.235.178.233,443,6,0.051023,6,4,2,446,283,163,97.995026,sSEfFR,0.051023
00:23:ae:9b:8a:bf,00:c1:b1:14:eb:31,192.168.10.16,56800,104.16.126.228,443,6,0.015231,4,3,1,265,205,60,196.966705,sSEfF,0.015231
00:23:ae:9b:8a:bf,00:c1:b1:14:eb:31,192.168.10.16,36072,72.30.3.43,443,6,0.024891,4,3,1,295,229,66,120.525490,sSEfF,0.024891
b8:ac:6f:1d:1f:6c,00:c1:b1:14:eb:31,192.168.10.9,63957,23.61.187.27,80,6,0.039744,2,1,1,126,60,66,25.161030,sSE,0.039744
00:23:ae:9b:8a:bf,00:c1:b1:14:eb:31,192.168.10.16,38662,209.197.3.19,443,6,0.019867,6,3,3,427,198,229,251.673645,sSEfF,0.019867
00:23:ae:9b:8a:bf,00:c1:b1:14:eb:31,192.168.10.16,58174,137.116.48.250,443,6,0.050209,2,1,1,132,66,66,19.916748,sSE,0.050209
00:19:b9:0a:69:f1,00:c1:b1:14:eb:31,192.168.10.50,123,199.182.221.110,123,17,0.072355,2,1,1,180,90,90,13.820745,CON,0.072355
00:19:b9:0a:69:f1,00:c1:b1:14:eb:31,192.168.10.50,123,206.108.0.133,123,17,0.022178,2,1,1,180,90,90,45.089729,CON,0.022178
00:23:ae:9b:8a:bf,00:c1:b1:14:eb:31,192.168.10.16,33352,204.79.197.200,443,6,0.022497,2,1,1,132,66,66,44.450371,sSE,0.022497
00:23:ae:9b:8a:bf,00:c1:b1:14:eb:31,192.168.10.16,39526,104.97.67.175,443,6,0.023614,2,1,1,132,66,66,42.347759,sSE,0.023614
b8:ac:6f:1d:1f:6c,18:66:da:9b:e3:7d,192.168.10.9,56276,192.168.10.3,53,17,0.030557,4,2,2,426,172,254,98.177177,CON,0.030557
18:66:da:9b:e3:7d,00:c1:b1:14:eb:31,192.168.10.3,61270,192.168.10.1,53,17,0.030532,2,1,1,235,97,138,32.752522,CON,0.030532
b8:ac:6f:1d:1f:6c,00:c1:b1:14:eb:31,192.168.10.9,62754,172.217.12.142,443,6,0.234817,3,2,1,260,160,100,8.517271,E,0.234817
b8:ac:6f:1d:1f:6c,00:c1:b1:14:eb:31,192.168.10.9,63960,184.84.243.192,80,6,0.022216,2,1,1,126,60,66,45.012604,sSE,0.022216
00:23:ae:9b:8a:bf,00:c1:b1:14:eb:31,192.168.10.16,53040,149.174.28.196,443,6,0.028482,2,1,1,120,60,60,35.109894,sSE,0.028482
00:23:ae:9b:8a:bf,00:c1:b1:14:eb:31,192.168.10.16,38716,104.244.43.112,443,6,0.120430,7,3,4,493,198,295,49.821472,sSEfF,0.120430
00:23:ae:9b:8a:bf,00:c1:b1:14:eb:31,192.168.10.16,35280,74.119.118.74,443,6,0.023052,2,1,1,132,66,66,43.380184,sSE,0.023052
00:1e:4f:d4:ca:28,00:c1:b1:14:eb:31,192.168.10.15,50246,52.84.40.136,80,6,0.030917,3,2,1,180,120,60,64.689331,sSEfF,0.030917
b8:ac:6f:1d:1f:6c,00:c1:b1:14:eb:31,192.168.10.9,63932,63.251.28.140,443,6,0.032519,2,1,1,120,60,60,30.751251,sSE,0.032519
b8:ac:6f:1d:1f:6c,00:c1:b1:14:eb:31,192.168.10.9,62902,72.21.91.29,80,6,0.023573,2,1,1,126,60,66,42.421413,E,0.023573
b8:ac:6f:1d:1f:6c,00:c1:b1:14:eb:31,192.168.10.9,62901,72.21.91.29,80,6,0.023774,2,1,1,126,60,66,42.062759,E,0.023774
b8:ac:6f:36:08:f5,18:66:da:9b:e3:7d,192.168.10.8,49235,192.168.10.3,53,17,0.031011,4,2,2,412,172,240,96.739868,CON,0.031011
18:66:da:9b:e3:7d,00:c1:b1:14:eb:31,192.168.10.3,61220,192.168.10.1,53,17,0.030847,2,1,1,228,97,131,32.418064,CON,0.030847
b8:ac:6f:36:08:f5,18:66:da:9b:e3:7d,192.168.10.8,63730,192.168.10.3,53,17,0.113857,4,2,2,468,170,298,26.348841,CON,0.113857
18:66:da:9b:e3:7d,00:c1:b1:14:eb:31,192.168.10.3,62091,192.168.10.1,53,17,0.113644,2,1,1,256,96,160,8.799409,CON,0.113644
00:c1:b1:14:eb:31,b8:ac:6f:1d:1f:6c,198.54.12.145,80,192.168.10.9,63046,6,0.001384,5,4,1,2437,2377,60,2890.173584,E,0.001384
b8:ac:6f:1d:1f:6c,00:c1:b1:14:eb:31,192.168.10.9,64002,173.241.242.220,80,6,0.331816,4,2,2,1935,875,1060,9.041156,sSE,0.331816
b8:ac:6f:1d:1f:6c,00:c1:b1:14:eb:31,192.168.10.9,64020,34.200.65.151,80,6,0.050967,2,1,1,126,60,66,19.620539,sSE,0.050967
b8:ac:6f:1d:1f:6c,00:c1:b1:14:eb:31,192.168.10.9,63913,199.187.193.130,443,6,0.060306,2,1,1,120,60,60,16.582098,sSE,0.060306
b8:ac:6f:1d:1f:6c,00:c1:b1:14:eb:31,192.168.10.9,63965,23.61.187.27,80,6,0.038985,2,1,1,126,60,66,25.650892,sSE,0.038985
00:23:ae:9b:8a:bf,00:c1:b1:14:eb:31,192.168.10.16,58308,198.8.70.212,443,6,0.384389,4,1,3,240,60,180,7.804594,sSEfR,0.384389
b8:ac:6f:1d:1f:6c,00:c1:b1:14:eb:31,192.168.10.9,63966,23.61.187.27,80,6,0.038910,2,1,1,126,60,66,25.700333,sSE,0.038910
00:23:ae:9b:8a:bf,00:c1:b1:14:eb:31,192.168.10.16,33412,204.79.197.200,443,6,0.022005,2,1,1,132,66,66,45.444218,sSE,0.022005
b8:ac:6f:1d:1f:6c,00:c1:b1:14:eb:31,192.168.10.9,63952,52.84.40.214,80,6,0.029903,2,1,1,126,60,66,33.441460,sSE,0.029903
b8:ac:6f:1d:1f:6c,00:c1:b1:14:eb:31,192.168.10.9,62884,23.61.187.27,80,6,0.038888,2,1,1,126,60,66,25.714874,E,0.038888
00:23:ae:9b:8a:bf,00:c1:b1:14:eb:31,192.168.10.16,53110,107.23.112.131,443,6,0.050403,2,1,1,132,66,66,19.840090,sSE,0.050403
00:23:ae:9b:8a:bf,00:c1:b1:14:eb:31,192.168.10.16,57312,23.208.153.242,443,6,0.023052,2,1,1,132,66,66,43.380184,sSE,0.023052
00:1e:4f:d4:ca:28,00:c1:b1:14:eb:31,192.168.10.15,50187,216.58.219.226,443,6,0.060325,3,2,1,260,160,100,33.153751,sSE,0.060325
b8:ac:6f:36:0b:a8,18:66:da:9b:e3:7d,192.168.10.51,46396,192.168.10.3,53,17,0.000028,4,2,2,368,152,216,107142.859375,CON,0.000028
00:23:ae:9b:8a:bf,00:c1:b1:14:eb:31,192.168.10.16,36166,198.51.152.184,443,6,0.023777,5,2,3,325,120,205,168.229797,sSEfF,0.023777
b8:ac:6f:1d:1f:6c,00:c1:b1:14:eb:31,192.168.10.9,63970,23.194.180.219,443,6,0.023361,2,1,1,126,60,66,42.806389,sSE,0.023361
b8:ac:6f:1d:1f:6c,00:c1:b1:14:eb:31,192.168.10.9,63953,23.61.187.27,80,6,0.038434,2,1,1,126,60,66,26.018631,sSE,0.038434
00:23:ae:9b:8a:bf,00:c1:b1:14:eb:31,192.168.10.16,43642,52.2.180.200,443,6,0.050199,2,1,1,132,66,66,19.920715,sSE,0.050199
00:23:ae:9b:8a:bf,00:c1:b1:14:eb:31,192.168.10.16,57918,23.50.75.27,80,6,0.023004,3,2,1,198,132,66,86.941406,sSEf,0.023004
00:23:ae:9b:8a:bf,00:c1:b1:14:eb:31,192.168.10.16,35732,131.253.61.64,443,6,0.045595,4,2,2,287,167,120,65.796684,sSEfFR,0.045595
00:23:ae:9b:8a:bf,00:c1:b1:14:eb:31,192.168.10.16,35734,131.253.61.64,443,6,0.045583,4,2,2,287,167,120,65.814011,sSEfFR,0.045583
00:23:ae:9b:8a:bf,00:c1:b1:14:eb:31,192.168.10.16,48122,107.21.253.211,443,6,0.050482,5,3,2,361,229,132,79.236160,sSEfF,0.050482
00:23:ae:9b:8a:bf,00:c1:b1:14:eb:31,192.168.10.16,37700,104.211.48.17,443,6,0.046519,4,2,2,311,185,126,64.489777,sSEfFR,0.046519
00:23:ae:9b:8a:bf,00:c1:b1:14:eb:31,192.168.10.16,57892,23.50.75.27,80,6,0.023453,4,2,2,264,132,132,127.915413,sSEf,0.023453
00:23:ae:9b:8a:bf,00:c1:b1:14:eb:31,192.168.10.16,44764,23.194.108.102,443,6,0.024564,6,4,2,446,283,163,203.549911,sSEfFR,0.024564
00:23:ae:9b:8a:bf,00:c1:b1:14:eb:31,192.168.10.16,48114,107.21.253.211,443,6,0.050960,6,3,3,427,229,198,98.116165,sSEfF,0.050960
00:23:ae:9b:8a:bf,00:c1:b1:14:eb:31,192.168.10.16,57916,23.50.75.27,80,6,0.023362,3,2,1,198,132,66,85.609108,sSEf,0.023362
00:23:ae:9b:8a:bf,00:c1:b1:14:eb:31,192.168.10.16,45398,72.167.239.239,80,6,0.029334,3,2,1,198,132,66,68.180267,sSEf,0.029334
00:23:ae:9b:8a:bf,00:c1:b1:14:eb:31,192.168.10.16,36164,198.51.152.184,443,6,0.023548,4,3,1,265,205,60,127.399361,sSEfF,0.023548
b8:ac:6f:1d:1f:6c,00:c1:b1:14:eb:31,192.168.10.9,63971,52.84.26.40,443,6,0.029565,2,1,1,126,60,66,33.823776,sSE,0.029565
00:23:ae:9b:8a:bf,00:c1:b1:14:eb:31,192.168.10.16,39690,68.67.178.173,443,6,0.032717,5,2,3,361,132,229,122.260597,sSEfF,0.032717
b8:ac:6f:36:08:f5,00:c1:b1:14:eb:31,192.168.10.8,49423,223.165.30.126,443,6,0.231961,5,3,2,347,227,120,17.244278,sSEfF,0.231961
b8:ac:6f:1d:1f:6c,00:c1:b1:14:eb:31,192.168.10.9,63943,8.39.37.45,443,6,0.087575,2,1,1,126,60,66,11.418783,sSE,0.087575
00:19:b9:0a:69:f1,00:c1:b1:14:eb:31,192.168.10.50,123,69.167.160.102,123,17,0.043140,2,1,1,180,90,90,23.180342,CON,0.043140
00:23:ae:9b:8a:bf,00:c1:b1:14:eb:31,192.168.10.16,36632,172.217.10.142,80,6,0.036939,2,1,1,132,66,66,27.071659,sSE,0.036939
00:23:ae:9b:8a:bf,00:c1:b1:14:eb:31,192.168.10.16,42258,204.11.109.67,443,6,0.087967,2,1,1,132,66,66,11.367899,sSE,0.087967
b8:ac:6f:36:0b:a8,00:c1:b1:14:eb:31,192.168.10.51,37357,23.61.187.27,80,6,0.037083,2,1,1,132,66,66,26.966534,sSE,0.037083
00:23:ae:9b:ad:b3,18:66:da:9b:e3:7d,192.168.10.19,3982,192.168.10.3,53,17,3.162367,4,2,2,276,138,138,0.948656,CON,3.162367
00:23:ae:9b:ad:b3,18:66:da:9b:e3:7d,192.168.10.19,44192,192.168.10.3,53,17,3.162367,4,2,2,276,138,138,0.948656,CON,3.162367
00:23:ae:9b:8a:bf,00:c1:b1:14:eb:31,192.168.10.16,51058,69.192.31.2,443,6,0.023183,2,1,1,132,66,66,43.135056,sSE,0.023183
b8:ac:6f:36:0b:a8,00:c1:b1:14:eb:31,192.168.10.51,37358,23.61.187.27,80,6,0.036619,2,1,1,132,66,66,27.308228,sSE,0.036619
00:1e:4f:d4:ca:28,00:c1:b1:14:eb:31,192.168.10.15,50091,23.23.220.195,443,6,0.288474,6,3,3,385,180,205,17.332584,EfF,0.288474
b8:ac:6f:36:08:f5,18:66:da:9b:e3:7d,192.168.10.8,59943,192.168.10.3,53,17,0.031075,4,2,2,408,170,238,96.540627,CON,0.031075
18:66:da:9b:e3:7d,00:c1:b1:14:eb:31,192.168.10.3,60314,192.168.10.1,53,17,0.030794,2,1,1,226,96,130,32.473858,CON,0.030794
00:23:ae:9b:8a:bf,00:c1:b1:14:eb:31,192.168.10.16,33416,204.79.197.200,443,6,0.022548,2,1,1,132,66,66,44.349834,sSE,0.022548
b8:ac:6f:1d:1f:6c,00:c1:b1:14:eb:31,192.168.10.9,62774,74.121.138.87,80,6,0.024199,2,1,1,126,60,66,41.324020,E,0.024199
00:23:ae:9b:8a:bf,00:c1:b1:14:eb:31,192.168.10.16,56826,23.205.26.97,443,6,0.022989,2,1,1,132,66,66,43.499065,sSE,0.022989
00:23:ae:9b:8a:bf,00:c1:b1:14:eb:31,192.168.10.16,33468,216.200.232.121,443,6,0.034979,2,1,1,132,66,66,28.588581,sSE,0.034979
b8:ac:6f:36:0b:a8,00:c1:b1:14:eb:31,192.168.10.51,35842,23.194.181.110,443,6,0.023305,2,1,1,132,66,66,42.909245,sSE,0.023305
18:66:da:9b:e3:7d,b8:ac:6f:36:08:f5,192.168.10.3,,192.168.10.8,,2054,0.000010,4,2,2,240,120,120,300000.000000,CON,0.000010
00:19:b9:0a:69:f1,00:c1:b1:14:eb:31,192.168.10.50,123,207.210.46.249,123,17,0.026321,2,1,1,180,90,90,37.992477,CON,0.026321
00:19:b9:0a:69:f1,00:c1:b1:14:eb:31,192.168.10.50,123,206.75.89.101,123,17,0.092799,2,1,1,180,90,90,10.775978,CON,0.092799
00:19:b9:0a:69:f1,00:c1:b1:14:eb:31,192.168.10.50,123,129.6.15.29,123,17,0.030268,2,1,1,180,90,90,33.038193,CON,0.030268
00:19:b9:0a:69:f1,00:c1:b1:14:eb:31,192.168.10.50,123,144.217.240.204,123,17,0.016142,2,1,1,180,90,90,61.950195,CON,0.016142
b8:ac:6f:36:08:f5,00:c1:b1:14:eb:31,192.168.10.8,49420,23.210.202.42,80,6,0.192570,2,1,1,126,60,66,5.192917,sSE,0.192570
b8:ac:6f:36:0b:a8,00:c1:b1:14:eb:31,192.168.10.51,57364,52.84.28.145,443,6,0.030998,2,1,1,132,66,66,32.260143,sSE,0.030998
00:23:ae:9b:8a:bf,00:c1:b1:14:eb:31,192.168.10.16,58420,198.8.70.212,443,6,0.000008,2,0,2,120,0,120,125000.000000,sSEfR,0.000008
00:23:ae:9b:8a:bf,00:c1:b1:14:eb:31,192.168.10.16,57776,23.50.75.27,80,6,0.022985,2,1,1,132,66,66,43.506634,sSE,0.022985
00:23:ae:9b:8a:bf,00:c1:b1:14:eb:31,192.168.10.16,34878,34.198.161.87,443,6,0.050736,2,1,1,132,66,66,19.709871,sSE,0.050736
00:23:ae:9b:ad:b3,00:c1:b1:14:eb:31,192.168.10.19,44162,151.101.0.67,443,6,0.014998,2,1,1,132,66,66,66.675560,sSE,0.014998
00:23:ae:9b:8a:bf,00:c1:b1:14:eb:31,192.168.10.16,58422,198.8.70.212,443,6,0.016097,3,1,2,180,60,120,124.246758,sSEfR,0.016097
00:23:ae:9b:8a:bf,00:c1:b1:14:eb:31,192.168.10.16,49646,192.243.250.36,443,6,0.034665,2,1,1,120,60,60,28.847542,sSE,0.034665
00:23:ae:9b:8a:bf,00:c1:b1:14:eb:31,192.168.10.16,52814,74.217.253.61,443,6,0.028505,2,1,1,132,66,66,35.081566,sSE,0.028505
00:23:ae:9b:8a:bf,00:c1:b1:14:eb:31,192.168.10.16,49656,192.243.250.36,443,6,0.034662,2,1,1,120,60,60,28.850037,sSE,0.034662
00:23:ae:9b:8a:bf,00:c1:b1:14:eb:31,192.168.10.16,49654,192.243.250.36,443,6,0.034657,2,1,1,120,60,60,28.854198,sSE,0.034657
00:23:ae:9b:8a:bf,00:c1:b1:14:eb:31,192.168.10.16,49648,192.243.250.36,443,6,0.034648,2,1,1,120,60,60,28.861694,sSE,0.034648
b8:ac:6f:36:0b:a8,00:c1:b1:14:eb:31,192.168.10.51,35846,23.194.181.110,443,6,0.023206,2,1,1,132,66,66,43.092304,sSE,0.023206
00:23:ae:9b:ad:b3,00:c1:b1:14:eb:31,192.168.10.19,44163,151.101.0.67,443,6,0.015009,2,1,1,132,66,66,66.626694,sSE,0.015009
00:23:ae:9b:ad:b3,00:c1:b1:14:eb:31,192.168.10.19,44161,151.101.0.67,443,6,0.014991,2,1,1,132,66,66,66.706688,sSE,0.014991
00:23:ae:9b:8a:bf,00:c1:b1:14:eb:31,192.168.10.16,59540,192.243.232.58,443,6,0.101893,2,1,1,120,60,60,9.814217,sSE,0.101893
b8:ac:6f:36:0b:a8,00:c1:b1:14:eb:31,192.168.10.51,44398,52.84.26.155,443,6,0.029670,2,1,1,132,66,66,33.704079,sSE,0.029670
00:23:ae:9b:8a:bf,00:c1:b1:14:eb:31,192.168.10.16,49674,192.243.250.36,443,6,0.034698,2,1,1,120,60,60,28.820107,sSE,0.034698
00:23:ae:9b:8a:bf,00:c1:b1:14:eb:31,192.168.10.16,49652,192.243.250.36,443,6,0.034681,2,1,1,120,60,60,28.834232,sSE,0.034681
b8:ac:6f:1d:1f:6c,00:c1:b1:14:eb:31,192.168.10.9,63078,198.54.12.145,443,6,0.059156,2,1,1,120,60,60,16.904455,E,0.059156
00:23:ae:9b:8a:bf,00:c1:b1:14:eb:31,192.168.10.16,39806,172.217.12.132,443,6,0.037070,6,2,4,1315,178,1137,134.879959,sSE,0.037070
00:23:ae:9b:8a:bf,00:c1:b1:14:eb:31,192.168.10.16,40076,172.217.12.131,443,6,0.129078,10,5,5,1162,634,528,69.725281,sSE,0.129078
00:23:ae:9b:ad:b3,00:c1:b1:14:eb:31,192.168.10.19,123,144.217.163.175,123,17,0.016197,2,1,1,180,90,90,61.739830,CON,0.016197
00:23:ae:9b:ad:b3,00:c1:b1:14:eb:31,192.168.10.19,123,129.128.12.20,123,17,0.093230,2,1,1,180,90,90,10.726161,CON,0.093230
00:23:ae:9b:8a:bf,00:c1:b1:14:eb:31,192.168.10.16,57664,23.50.75.27,80,6,0.022959,2,1,1,132,66,66,43.555904,sSE,0.022959
00:23:ae:9b:8a:bf,00:c1:b1:14:eb:31,192.168.10.16,48988,208.185.118.91,80,6,0.028043,2,1,1,132,66,66,35.659523,sSE,0.028043
b8:ac:6f:1d:1f:6c,00:c1:b1:14:eb:31,192.168.10.9,63248,23.194.180.169,80,6,4.479989,6,3,3,1213,555,658,1.116074,E,4.479989
00:23:ae:9b:8a:bf,00:c1:b1:14:eb:31,192.168.10.16,39704,68.67.178.173,443,6,0.032095,5,2,3,361,132,229,124.630005,sSEfF,0.032095
b8:ac:6f:1d:1f:6c,00:c1:b1:14:eb:31,192.168.10.9,63090,198.54.12.145,443,6,0.059395,2,1,1,120,60,60,16.836433,E,0.059395
00:23:ae:9b:8a:bf,00:c1:b1:14:eb:31,192.168.10.16,47632,23.52.145.165,443,6,0.023482,2,1,1,132,66,66,42.585808,sSE,0.023482
00:23:ae:9b:8a:bf,00:c1:b1:14:eb:31,192.168.10.16,48854,64.12.245.38,443,6,0.028554,2,1,1,120,60,60,35.021362,sSE,0.028554
b8:ac:6f:36:0b:a8,00:c1:b1:14:eb:31,192.168.10.51,58045,172.217.6.200,443,6,0.036400,2,1,1,132,66,66,27.472527,sSE,0.036400
00:23:ae:9b:ad:b3,00:c1:b1:14:eb:31,192.168.10.19,48658,172.217.12.174,80,6,5.013527,5,3,2,330,198,132,0.797842,sSEfF,5.013527
b8:ac:6f:1d:1f:6c,00:c1:b1:14:eb:31,192.168.10.9,64056,52.1.14.213,80,6,0.050622,2,1,1,126,60,66,19.754257,sSE,0.050622
b8:ac:6f:36:08:f5,00:c1:b1:14:eb:31,192.168.10.8,49429,223.165.30.126,80,6,0.232533,3,2,1,180,120,60,8.600930,sSEf,0.232533
b8:ac:6f:36:08:f5,00:c1:b1:14:eb:31,192.168.10.8,49427,223.165.30.126,80,6,0.227325,3,2,1,180,120,60,8.797976,sSEf,0.227325
b8:ac:6f:36:08:f5,00:c1:b1:14:eb:31,192.168.10.8,49432,54.192.37.122,443,6,0.000000,2,1,1,120,60,60,0.000000,sSEfF,0.000000
00:23:ae:9b:ad:b3,00:c1:b1:14:eb:31,192.168.10.19,54443,151.101.20.67,443,6,4.872386,8,5,3,578,349,229,1.436668,sSEfFR,4.872386
00:23:ae:9b:8a:bf,00:c1:b1:14:eb:31,192.168.10.16,55278,173.223.155.124,443,6,0.023750,2,1,1,132,66,66,42.105263,sSE,0.023750
00:23:ae:9b:ad:b3,00:c1:b1:14:eb:31,192.168.10.19,46847,172.217.3.110,443,6,4.853958,6,4,2,427,295,132,1.030087,sSEfF,4.853958
00:23:ae:9b:8a:bf,00:c1:b1:14:eb:31,192.168.10.16,33292,204.11.109.65,443,6,0.087718,2,1,1,132,66,66,11.400168,sSE,0.087718
00:23:ae:9b:8a:bf,00:c1:b1:14:eb:31,192.168.10.16,53972,50.18.253.140,443,6,0.088611,2,1,1,132,66,66,11.285280,sSE,0.088611
00:23:ae:9b:8a:bf,00:c1:b1:14:eb:31,192.168.10.16,59606,192.243.232.58,443,6,0.101902,2,1,1,120,60,60,9.813350,sSE,0.101902
00:23:ae:9b:8a:bf,00:c1:b1:14:eb:31,192.168.10.16,40404,93.92.100.173,443,6,0.102501,2,1,1,132,66,66,9.756002,sSE,0.102501
00:23:ae:9b:8a:bf,00:c1:b1:14:eb:31,192.168.10.16,36060,74.217.253.60,443,6,0.028336,2,1,1,132,66,66,35.290798,sSE,0.028336
00:23:ae:9b:8a:bf,00:c1:b1:14:eb:31,192.168.10.16,50900,34.196.190.130,443,6,0.050571,2,1,1,132,66,66,19.774179,sSE,0.050571
00:23:ae:9b:8a:bf,00:c1:b1:14:eb:31,192.168.10.16,50944,34.196.190.130,443,6,0.050879,2,1,1,132,66,66,19.654474,sSE,0.050879
00:23:ae:9b:8a:bf,00:c1:b1:14:eb:31,192.168.10.16,54890,54.192.37.11,443,6,0.030927,2,1,1,132,66,66,32.334206,sSE,0.030927
00:23:ae:9b:8a:bf,00:c1:b1:14:eb:31,192.168.10.16,57542,23.50.75.27,80,6,0.023130,2,1,1,132,66,66,43.233894,sSE,0.023130
00:23:ae:9b:8a:bf,00:c1:b1:14:eb:31,192.168.10.16,49276,104.16.28.216,80,6,0.014888,2,1,1,120,60,60,67.168190,sSE,0.014888
00:23:ae:9b:8a:bf,00:c1:b1:14:eb:31,192.168.10.16,50940,34.196.190.130,443,6,0.051114,2,1,1,132,66,66,19.564112,sSE,0.051114
00:23:ae:9b:8a:bf,00:c1:b1:14:eb:31,192.168.10.16,50946,34.196.190.130,443,6,0.050602,2,1,1,132,66,66,19.762064,sSE,0.050602
00:23:ae:9b:8a:bf,00:c1:b1:14:eb:31,192.168.10.16,34094,54.236.72.117,443,6,0.051055,6,3,3,427,198,229,97.933601,sSEfF,0.051055
00:23:ae:9b:8a:bf,00:c1:b1:14:eb:31,192.168.10.16,50808,72.21.91.29,80,6,0.023888,2,1,1,132,66,66,41.862022,sSE,0.023888
00:23:ae:9b:8a:bf,00:c1:b1:14:eb:31,192.168.10.16,49022,50.16.134.233,443,6,0.050731,2,1,1,132,66,66,19.711813,sSE,0.050731
b8:ac:6f:36:0b:a8,00:c1:b1:14:eb:31,192.168.10.51,46937,69.147.64.33,443,6,0.062567,7,3,4,493,198,295,95.897194,sSEfF,0.062567
b8:ac:6f:36:0b:a8,00:c1:b1:14:eb:31,192.168.10.51,48889,104.88.70.158,443,6,0.023129,2,1,1,132,66,66,43.235767,sSE,0.023129
b8:ac:6f:36:0b:a8,00:c1:b1:14:eb:31,192.168.10.51,59019,52.84.30.244,443,6,0.031302,2,1,1,132,66,66,31.946838,sSE,0.031302
00:23:ae:9b:8a:bf,00:c1:b1:14:eb:31,192.168.10.16,48512,8.39.37.45,443,6,0.087350,2,1,1,120,60,60,11.448196,sSE,0.087350
00:23:ae:9b:8a:bf,00:c1:b1:14:eb:31,192.168.10.16,48510,8.39.37.45,443,6,0.086649,2,1,1,120,60,60,11.540814,sSE,0.086649
b8:ac:6f:36:0b:a8,00:c1:b1:14:eb:31,192.168.10.51,38477,172.217.10.70,443,6,0.036277,2,1,1,132,66,66,27.565676,sSE,0.036277
b8:ac:6f:36:0b:a8,00:c1:b1:14:eb:31,192.168.10.51,45753,172.217.3.110,443,6,0.036932,2,1,1,132,66,66,27.076790,sSE,0.036932
00:23:ae:9b:8a:bf,00:c1:b1:14:eb:31,192.168.10.16,50952,34.196.190.130,443,6,0.050806,2,1,1,132,66,66,19.682714,sSE,0.050806
00:23:ae:9b:8a:bf,00:c1:b1:14:eb:31,192.168.10.16,45402,98.139.225.43,443,6,0.024751,2,1,1,132,66,66,40.402409,sSE,0.024751
00:23:ae:9b:8a:bf,00:c1:b1:14:eb:31,192.168.10.16,51678,173.241.242.143,443,6,0.036169,2,1,1,120,60,60,27.647985,sSE,0.036169
00:19:b9:0a:69:f1,00:c1:b1:14:eb:31,192.168.10.50,123,154.16.245.246,123,17,0.066559,2,1,1,180,90,90,15.024263,CON,0.066559
00:23:ae:9b:8a:bf,00:c1:b1:14:eb:31,192.168.10.16,57634,23.50.75.27,80,6,0.022862,2,1,1,132,66,66,43.740704,sSE,0.022862
00:23:ae:9b:8a:bf,00:c1:b1:14:eb:31,192.168.10.16,57628,23.50.75.27,80,6,0.022861,2,1,1,132,66,66,43.742619,sSE,0.022861
00:23:ae:9b:8a:bf,00:c1:b1:14:eb:31,192.168.10.16,50760,34.196.190.130,443,6,0.050281,2,1,1,132,66,66,19.888227,sSE,0.050281
b8:ac:6f:36:08:f5,00:c1:b1:14:eb:31,192.168.10.8,49441,23.203.74.20,80,6,0.023023,3,2,1,180,120,60,86.869652,sSEf,0.023023
b8:ac:6f:36:08:f5,00:c1:b1:14:eb:31,192.168.10.8,49440,23.203.74.20,80,6,0.023016,4,2,2,240,120,120,130.344101,sSEf,0.023016
b8:ac:6f:36:08:f5,00:c1:b1:14:eb:31,192.168.10.8,49438,23.203.74.20,80,6,0.023012,3,2,1,180,120,60,86.911179,sSEf,0.023012
b8:ac:6f:36:08:f5,00:c1:b1:14:eb:31,192.168.10.8,49426,223.165.30.126,80,6,0.227735,3,2,1,180,120,60,8.782137,sSEfF,0.227735
b8:ac:6f:36:08:f5,00:c1:b1:14:eb:31,192.168.10.8,49435,54.192.39.67,80,6,0.028955,3,2,1,180,120,60,69.072701,sSEf,0.028955
b8:ac:6f:36:0b:a8,00:c1:b1:14:eb:31,192.168.10.51,54785,52.84.33.9,443,6,0.030732,2,1,1,132,66,66,32.539371,sSE,0.030732
b8:ac:6f:36:0b:a8,00:c1:b1:14:eb:31,192.168.10.51,37399,23.61.187.27,80,6,0.038825,2,1,1,132,66,66,25.756599,sSE,0.038825
b8:ac:6f:36:0b:a8,00:c1:b1:14:eb:31,192.168.10.51,50364,96.43.146.134,443,6,0.042293,2,1,1,132,66,66,23.644575,sSE,0.042293
b8:ac:6f:36:0b:a8,00:c1:b1:14:eb:31,192.168.10.51,46321,52.84.26.175,443,6,0.029845,2,1,1,132,66,66,33.506451,sSE,0.029845
00:23:ae:9b:8a:bf,00:c1:b1:14:eb:31,192.168.10.16,36074,72.30.3.43,443,6,0.025229,2,1,1,132,66,66,39.636925,sSE,0.025229
00:23:ae:9b:8a:bf,00:c1:b1:14:eb:31,192.168.10.16,51066,23.194.108.108,443,6,0.023981,2,1,1,132,66,66,41.699680,sSE,0.023981
b8:ac:6f:36:0b:a8,00:c1:b1:14:eb:31,192.168.10.51,38550,74.125.22.154,443,6,0.049192,2,1,1,132,66,66,20.328508,sSE,0.049192
b8:ac:6f:36:0b:a8,00:c1:b1:14:eb:31,192.168.10.51,37405,23.61.187.27,80,6,0.036487,2,1,1,132,66,66,27.407022,sSE,0.036487
00:23:ae:9b:ad:b3,18:66:da:9b:e3:7d,192.168.10.19,50788,192.168.10.3,53,17,0.000002,2,0,2,138,0,138,500000.000000,RSP,0.000002
00:23:ae:9b:ad:b3,18:66:da:9b:e3:7d,192.168.10.19,24388,192.168.10.3,53,17,0.000002,2,0,2,138,0,138,500000.000000,RSP,0.000002
00:23:ae:9b:ad:b3,18:66:da:9b:e3:7d,192.168.10.19,51738,192.168.10.3,53,17,0.000002,2,2,0,138,138,0,500000.000000,INT,0.000002
00:23:ae:9b:ad:b3,18:66:da:9b:e3:7d,192.168.10.19,52286,192.168.10.3,53,17,0.000001,2,2,0,138,138,0,1000000.000000,INT,0.000001
18:66:da:9b:e3:7d,00:c1:b1:14:eb:31,192.168.10.3,60735,192.168.10.1,53,17,0.292082,2,1,1,160,80,80,3.423696,CON,0.292082
18:66:da:9b:e3:7d,00:c1:b1:14:eb:31,192.168.10.3,62243,192.168.10.1,53,17,0.366690,2,1,1,160,80,80,2.727099,CON,0.366690
b8:ac:6f:36:0b:a8,00:c1:b1:14:eb:31,192.168.10.51,32907,96.43.146.17,443,6,0.043437,2,1,1,132,66,66,23.021847,sSE,0.043437
b8:ac:6f:36:0b:a8,00:c1:b1:14:eb:31,192.168.10.51,53763,209.167.231.17,443,6,0.022763,2,1,1,132,66,66,43.930939,sSE,0.022763
b8:ac:6f:36:0b:a8,00:c1:b1:14:eb:31,192.168.10.51,50260,104.70.0.193,443,6,0.099094,2,1,1,132,66,66,10.091428,sSE,0.099094
b8:ac:6f:36:0b:a8,00:c1:b1:14:eb:31,192.168.10.51,35508,172.217.12.132,443,6,0.036831,2,1,1,132,66,66,27.151043,sSE,0.036831
b8:ac:6f:36:0a:8b,00:c1:b1:14:eb:31,192.168.10.5,51955,8.41.222.134,443,6,0.032859,2,1,1,120,60,60,30.433062,sSE,0.032859
b8:ac:6f:36:0b:a8,00:c1:b1:14:eb:31,192.168.10.51,45802,172.217.3.110,443,6,0.037176,2,1,1,132,66,66,26.899073,sSE,0.037176
b8:ac:6f:36:0b:a8,00:c1:b1:14:eb:31,192.168.10.51,59258,34.206.223.3,443,6,0.051425,2,1,1,132,66,66,19.445795,sSE,0.051425
00:23:ae:9b:8a:bf,00:c1:b1:14:eb:31,192.168.10.16,51752,65.55.44.109,443,6,0.050097,2,1,1,132,66,66,19.961275,sSE,0.050097
00:23:ae:9b:8a:bf,00:c1:b1:14:eb:31,192.168.10.16,39546,104.97.67.175,443,6,0.023253,2,1,1,132,66,66,43.005203,sSE,0.023253
00:23:ae:9b:8a:bf,00:c1:b1:14:eb:31,192.168.10.16,53114,107.23.112.131,443,6,0.050067,2,1,1,132,66,66,19.973236,sSE,0.050067
00:23:ae:9b:8a:bf,00:c1:b1:14:eb:31,192.168.10.16,55240,65.52.108.11,443,6,0.050061,2,1,1,132,66,66,19.975630,sSE,0.050061
b8:ac:6f:36:0b:a8,00:c1:b1:14:eb:31,192.168.10.51,45848,130.211.18.204,443,6,0.052963,2,1,1,132,66,66,18.881105,sSE,0.052963
b8:ac:6f:36:0b:a8,00:c1:b1:14:eb:31,192.168.10.51,35344,172.217.10.142,80,6,0.036793,2,1,1,132,66,66,27.179083,sSE,0.036793
b8:ac:6f:1d:1f:6c,00:c1:b1:14:eb:31,192.168.10.9,64058,23.194.108.45,80,6,0.023673,4,2,2,240,120,120,126.726654,sSEf,0.023673
b8:ac:6f:36:0b:a8,00:c1:b1:14:eb:31,192.168.10.51,59272,34.206.223.3,443,6,0.050000,2,1,1,132,66,66,20.000000,sSE,0.050000
b8:ac:6f:36:0b:a8,00:c1:b1:14:eb:31,192.168.10.51,59271,34.206.223.3,443,6,0.050717,2,1,1,132,66,66,19.717255,sSE,0.050717
b8:ac:6f:1d:1f:6c,00:c1:b1:14:eb:31,192.168.10.9,64059,34.202.69.17,80,6,0.050880,4,2,2,240,120,120,58.962265,sSEfF,0.050880
b8:ac:6f:36:0b:a8,00:c1:b1:14:eb:31,192.168.10.51,36620,172.217.12.131,443,6,0.036647,2,1,1,132,66,66,27.287363,sSE,0.036647
00:23:ae:9b:ad:b3,00:c1:b1:14:eb:31,192.168.10.19,123,206.108.0.134,123,17,0.028949,2,1,1,180,90,90,34.543507,CON,0.028949
b8:ac:6f:36:0b:a8,00:c1:b1:14:eb:31,192.168.10.51,57388,34.193.204.90,443,6,0.051152,2,1,1,132,66,66,19.549578,sSE,0.051152
b8:ac:6f:1d:1f:6c,00:c1:b1:14:eb:31,192.168.10.9,64060,162.208.22.34,80,6,0.000000,1,0,1,60,0,60,0.000000,sSEfF,0.000000
b8:ac:6f:1d:1f:6c,00:c1:b1:14:eb:31,192.168.10.9,64061,162.208.22.34,80,6,0.000000,1,0,1,60,0,60,0.000000,sSEfF,0.000000
b8:ac:6f:36:0a:8b,00:c1:b1:14:eb:31,192.168.10.5,52106,206.126.112.150,443,6,0.015152,2,1,1,126,60,66,65.997887,sSE,0.015152
b8:ac:6f:36:0b:a8,00:c1:b1:14:eb:31,192.168.10.51,42186,216.58.217.142,443,6,0.042827,2,1,1,132,66,66,23.349756,sSE,0.042827
00:23:ae:9b:8a:bf,00:c1:b1:14:eb:31,192.168.10.16,50806,72.21.91.29,80,6,0.024010,2,1,1,132,66,66,41.649311,sSE,0.024010
00:23:ae:9b:8a:bf,00:c1:b1:14:eb:31,192.168.10.16,50800,72.21.91.29,80,6,0.024009,2,1,1,132,66,66,41.651047,sSE,0.024009
b8:ac:6f:1d:1f:6c,00:c1:b1:14:eb:31,192.168.10.9,63064,198.54.12.145,443,6,0.059367,2,1,1,120,60,60,16.844374,E,0.059367
00:23:ae:9b:8a:bf,00:c1:b1:14:eb:31,192.168.10.16,35062,54.235.178.233,443,6,0.051277,2,1,1,132,66,66,19.501921,sSE,0.051277
00:23:ae:9b:8a:bf,00:c1:b1:14:eb:31,192.168.10.16,56798,104.16.126.228,443,6,0.015070,2,1,1,120,60,60,66.357002,sSE,0.015070
b8:ac:6f:36:0b:a8,00:c1:b1:14:eb:31,192.168.10.51,45771,172.217.3.110,443,6,0.036942,2,1,1,132,66,66,27.069460,sSE,0.036942
b8:ac:6f:36:08:f5,00:c1:b1:14:eb:31,192.168.10.8,49446,72.21.91.29,80,6,0.023581,3,2,1,180,120,60,84.814049,sSEf,0.023581
b8:ac:6f:36:08:f5,00:c1:b1:14:eb:31,192.168.10.8,49445,52.216.1.208,443,6,0.050514,5,3,2,350,205,145,79.185966,sSEfFR,0.050514
b8:ac:6f:1d:1f:6c,00:c1:b1:14:eb:31,192.168.10.9,63091,198.54.12.145,443,6,1.881994,7,2,5,2653,120,2533,3.188108,E,1.881994
b8:ac:6f:36:0b:a8,00:c1:b1:14:eb:31,192.168.10.51,36789,72.21.91.29,80,6,0.023833,2,1,1,132,66,66,41.958630,sSE,0.023833
00:23:ae:9b:8a:bf,00:c1:b1:14:eb:31,192.168.10.16,54546,68.67.178.197,443,6,0.031985,4,1,3,295,66,229,93.793968,sSEfF,0.031985
00:23:ae:9b:8a:bf,00:c1:b1:14:eb:31,192.168.10.16,54556,68.67.178.197,443,6,0.032266,5,2,3,361,132,229,123.969513,sSEfF,0.032266
00:23:ae:9b:8a:bf,00:c1:b1:14:eb:31,192.168.10.16,57876,23.50.75.27,80,6,0.023253,2,1,1,132,66,66,43.005203,sSE,0.023253
00:23:ae:9b:8a:bf,00:c1:b1:14:eb:31,192.168.10.16,57878,23.50.75.27,80,6,0.023250,2,1,1,132,66,66,43.010750,sSE,0.023250
00:23:ae:9b:8a:bf,00:c1:b1:14:eb:31,192.168.10.16,56190,104.16.66.157,443,6,0.015208,2,1,1,120,60,60,65.754868,sSE,0.015208
00:23:ae:9b:8a:bf,00:c1:b1:14:eb:31,192.168.10.16,57886,23.50.75.27,80,6,0.023247,2,1,1,132,66,66,43.016304,sSE,0.023247
b8:ac:6f:36:0b:a8,00:c1:b1:14:eb:31,192.168.10.51,32931,96.43.146.17,443,6,0.041171,2,1,1,132,66,66,24.288942,sSE,0.041171
b8:ac:6f:36:07:ee,00:c1:b1:14:eb:31,192.168.10.14,51834,54.225.135.201,443,6,0.050668,2,1,1,126,60,66,19.736322,sSE,0.050668
00:23:ae:9b:8a:bf,00:c1:b1:14:eb:31,192.168.10.16,54868,68.67.178.197,443,6,0.032368,5,2,3,361,132,229,123.578842,sSEfF,0.032368
00:23:ae:9b:8a:bf,00:c1:b1:14:eb:31,192.168.10.16,59830,174.129.244.5,443,6,0.050264,2,1,1,132,66,66,19.894955,sSE,0.050264
b8:ac:6f:36:08:f5,00:c1:b1:14:eb:31,192.168.10.8,49444,52.216.1.208,443,6,0.050316,4,2,2,265,120,145,59.623184,sSEfF,0.050316
00:c1:b1:14:eb:31,b8:ac:6f:1d:1f:6c,192.35.249.124,80,192.168.10.9,63033,6,1.700777,23,17,6,15833,15473,360,12.935264,E,1.700777
b8:ac:6f:36:08:f5,00:c1:b1:14:eb:31,192.168.10.8,49443,52.216.1.208,443,6,0.050805,4,2,2,265,120,145,59.049309,sSEfF,0.050805
b8:ac:6f:36:08:f5,00:c1:b1:14:eb:31,192.168.10.8,49424,223.165.30.126,80,6,0.232524,2,1,1,120,60,60,4.300632,sSE,0.232524
b8:ac:6f:36:0b:a8,00:c1:b1:14:eb:31,192.168.10.51,37382,23.61.187.27,80,6,0.038923,2,1,1,132,66,66,25.691751,sSE,0.038923
b8:ac:6f:1d:1f:6c,00:c1:b1:14:eb:31,192.168.10.9,63082,198.54.12.145,443,6,0.059049,2,1,1,120,60,60,16.935087,E,0.059049
b8:ac:6f:1d:1f:6c,00:c1:b1:14:eb:31,192.168.10.9,62754,172.217.12.142,443,6,0.040289,6,4,2,425,305,120,124.103355,EfF,0.040289
b8:ac:6f:36:0b:a8,00:c1:b1:14:eb:31,192.168.10.51,57167,96.43.146.50,443,6,0.043159,2,1,1,132,66,66,23.170137,sSE,0.043159
b8:ac:6f:1d:1f:6c,00:c1:b1:14:eb:31,192.168.10.9,64062,162.208.22.34,80,6,0.043955,4,2,2,240,120,120,68.251625,sSEf,0.043955
b8:ac:6f:1d:1f:6c,00:c1:b1:14:eb:31,192.168.10.9,64063,162.208.22.34,80,6,0.038852,3,2,1,180,120,60,51.477402,sSEf,0.038852
b8:ac:6f:1d:1f:6c,00:c1:b1:14:eb:31,192.168.10.9,64070,208.81.233.48,80,6,0.040384,3,2,1,180,120,60,49.524567,sSEf,0.040384
b8:ac:6f:1d:1f:6c,00:c1:b1:14:eb:31,192.168.10.9,64066,23.194.108.45,80,6,0.023998,3,2,1,180,120,60,83.340279,sSEf,0.023998
b8:ac:6f:1d:1f:6c,00:c1:b1:14:eb:31,192.168.10.9,64068,72.30.202.150,80,6,0.024855,2,1,1,120,60,60,40.233353,sSEfR,0.024855
00:23:ae:9b:8a:bf,00:c1:b1:14:eb:31,192.168.10.16,40586,77.247.179.176,443,6,0.000000,1,1,0,60,60,0,0.000000,EfF,0.000000
00:23:ae:9b:8a:bf,00:c1:b1:14:eb:31,192.168.10.16,40584,77.247.179.176,443,6,0.000000,1,1,0,60,60,0,0.000000,EfF,0.000000
00:23:ae:9b:8a:bf,00:c1:b1:14:eb:31,192.168.10.16,47850,107.21.253.211,443,6,0.050830,2,1,1,132,66,66,19.673422,sSE,0.050830
b8:ac:6f:1d:1f:6c,00:c1:b1:14:eb:31,192.168.10.9,63992,54.228.200.142,443,6,0.102494,2,1,1,126,60,66,9.756668,sSE,0.102494
00:1e:4f:d4:ca:28,00:c1:b1:14:eb:31,192.168.10.15,50215,74.121.142.165,443,6,0.023966,2,1,1,126,60,66,41.725780,sSE,0.023966
b8:ac:6f:1d:1f:6c,00:c1:b1:14:eb:31,192.168.10.9,63980,23.21.84.138,80,6,0.634850,6,3,3,360,180,180,7.875876,sSEfF,0.634850
00:23:ae:9b:8a:bf,00:c1:b1:14:eb:31,192.168.10.16,54670,52.45.120.198,443,6,0.051115,2,1,1,132,66,66,19.563730,sSE,0.051115
00:23:ae:9b:8a:bf,00:c1:b1:14:eb:31,192.168.10.16,57914,23.50.75.27,80,6,0.022950,2,1,1,132,66,66,43.572987,sSE,0.022950
00:23:ae:9b:8a:bf,00:c1:b1:14:eb:31,192.168.10.16,57912,23.50.75.27,80,6,0.022962,2,1,1,132,66,66,43.550213,sSE,0.022962
00:23:ae:9b:8a:bf,00:c1:b1:14:eb:31,192.168.10.16,37702,104.211.48.17,443,6,0.046249,2,1,1,132,66,66,21.622089,sSE,0.046249
00:23:ae:9b:8a:bf,00:c1:b1:14:eb:31,192.168.10.16,47156,104.88.33.156,443,6,0.023261,2,1,1,132,66,66,42.990414,sSE,0.023261
00:1e:4f:d4:ca:28,00:c1:b1:14:eb:31,192.168.10.15,50489,134.170.58.121,443,6,1.068790,98,49,49,67051,19369,47682,90.756844,sSEfF,1.068790
b8:ac:6f:36:0a:8b,00:c1:b1:14:eb:31,192.168.10.5,52076,52.72.49.160,443,6,0.050663,2,1,1,126,60,66,19.738270,sSE,0.050663
b8:ac:6f:1d:1f:6c,00:c1:b1:14:eb:31,192.168.10.9,63228,54.192.37.217,443,6,0.230921,3,2,1,260,160,100,8.660971,E,0.230921
00:23:ae:9b:8a:bf,00:c1:b1:14:eb:31,192.168.10.16,51690,173.241.242.143,443,6,0.000000,2,1,1,361,60,301,0.000000,sSEfFR,0.000000
b8:ac:6f:1d:1f:6c,00:c1:b1:14:eb:31,192.168.10.9,63880,151.101.2.49,80,6,0.014913,2,1,1,126,60,66,67.055588,sSE,0.014913
00:23:ae:9b:8a:bf,00:c1:b1:14:eb:31,192.168.10.16,52062,23.99.229.108,443,6,0.049734,2,1,1,132,66,66,20.106970,sSE,0.049734
00:23:ae:9b:ad:b3,00:c1:b1:14:eb:31,192.168.10.19,123,206.108.0.132,123,17,0.028650,2,1,1,180,90,90,34.904015,CON,0.028650
00:19:b9:0a:69:f1,33:33:00:00:00:fb,fe80::3e30:c3c4:d72f:ae4c,5353,ff02::fb,5353,17,0.000102,26,26,0,4680,4680,0,245098.046875,INT,0.000102
00:19:b9:0a:69:f1,01:00:5e:00:00:fb,192.168.10.50,5353,224.0.0.251,5353,17,0.000070,26,26,0,4160,4160,0,357142.843750,INT,0.000070
b8:ac:6f:1d:1f:6c,18:66:da:9b:e3:7d,192.168.10.9,65156,192.168.10.3,53,17,0.030820,4,2,2,486,152,334,97.339386,CON,0.030820
18:66:da:9b:e3:7d,00:c1:b1:14:eb:31,192.168.10.3,62509,192.168.10.1,53,17,0.030218,2,1,1,202,93,109,33.092857,CON,0.030218
b8:ac:6f:1d:1f:6c,18:66:da:9b:e3:7d,192.168.10.9,54841,192.168.10.3,53,17,0.029025,4,2,2,486,152,334,103.359177,CON,0.029025
b8:ac:6f:1d:1f:6c,18:66:da:9b:e3:7d,192.168.10.9,50361,192.168.10.3,53,17,0.000201,4,2,2,486,152,334,14925.373047,CON,0.000201
b8:ac:6f:1d:1f:6c,18:66:da:9b:e3:7d,192.168.10.9,56137,192.168.10.3,53,17,0.000158,4,2,2,360,164,196,18987.341797,CON,0.000158
b8:ac:6f:1d:1f:6c,18:66:da:9b:e3:7d,192.168.10.9,56864,192.168.10.3,53,17,0.000186,4,2,2,486,152,334,16129.032227,CON,0.000186
b8:ac:6f:1d:1f:6c,18:66:da:9b:e3:7d,192.168.10.9,61040,192.168.10.3,53,17,0.000069,4,2,2,360,164,196,43478.261719,CON,0.000069
b8:ac:6f:1d:1f:6c,00:c1:b1:14:eb:31,192.168.10.9,63881,172.217.10.70,80,6,0.036451,2,1,1,126,60,66,27.434090,sSE,0.036451
00:23:ae:9b:8a:bf,00:c1:b1:14:eb:31,192.168.10.16,43274,104.88.33.156,80,6,0.022915,2,1,1,132,66,66,43.639538,sSE,0.022915
b8:ac:6f:1d:1f:6c,00:c1:b1:14:eb:31,192.168.10.9,64071,23.194.108.45,80,6,0.024104,3,2,1,192,126,66,82.973785,sSE,0.024104
b8:ac:6f:1d:1f:6c,00:c1:b1:14:eb:31,192.168.10.9,63065,52.2.56.173,80,6,0.852174,11,6,5,6158,2542,3616,11.734693,E,0.852174
b8:ac:6f:1d:1f:6c,00:c1:b1:14:eb:31,192.168.10.9,63260,198.54.12.111,80,6,0.519544,10,4,6,3159,1719,1440,17.322884,E,0.519544
b8:ac:6f:1d:1f:6c,18:66:da:9b:e3:7d,192.168.10.9,62787,192.168.10.3,53,17,0.030921,4,2,2,414,168,246,97.021446,CON,0.030921
18:66:da:9b:e3:7d,00:c1:b1:14:eb:31,192.168.10.3,61413,192.168.10.1,53,17,0.030339,2,1,1,194,89,105,32.960876,CON,0.030339
b8:ac:6f:1d:1f:6c,18:66:da:9b:e3:7d,192.168.10.9,50181,192.168.10.3,53,17,0.030627,4,2,2,414,168,246,97.952789,CON,0.030627
b8:ac:6f:1d:1f:6c,18:66:da:9b:e3:7d,192.168.10.9,51850,192.168.10.3,53,17,0.030472,4,2,2,414,168,246,98.451042,CON,0.030472
18:66:da:9b:e3:7d,00:c1:b1:14:eb:31,192.168.10.3,61580,192.168.10.1,53,17,0.030083,2,1,1,194,89,105,33.241364,CON,0.030083
b8:ac:6f:1d:1f:6c,18:66:da:9b:e3:7d,192.168.10.9,64144,192.168.10.3,53,17,0.030275,4,2,2,414,168,246,99.091660,CON,0.030275
b8:ac:6f:1d:1f:6c,18:66:da:9b:e3:7d,192.168.10.9,59236,192.168.10.3,53,17,0.000213,4,2,2,414,168,246,14084.506836,CON,0.000213
b8:ac:6f:1d:1f:6c,00:c1:b1:14:eb:31,192.168.10.9,64072,162.208.22.34,80,6,0.325292,9,5,4,2021,697,1324,24.593288,sSE,0.325292
b8:ac:6f:1d:1f:6c,00:c1:b1:14:eb:31,192.168.10.9,64073,162.208.22.34,80,6,0.406521,7,4,3,1356,631,725,14.759385,sSE,0.406521
b8:ac:6f:1d:1f:6c,18:66:da:9b:e3:7d,192.168.10.9,54660,192.168.10.3,53,17,0.000203,4,2,2,344,156,188,14778.325195,CON,0.000203
b8:ac:6f:1d:1f:6c,00:c1:b1:14:eb:31,192.168.10.9,63039,198.54.12.145,80,6,0.000000,4,1,3,452,60,392,0.000000,E,0.000000
b8:ac:6f:1d:1f:6c,18:66:da:9b:e3:7d,192.168.10.9,52927,192.168.10.3,53,17,0.000206,4,2,2,344,156,188,14563.107422,CON,0.000206
b8:ac:6f:1d:1f:6c,18:66:da:9b:e3:7d,192.168.10.9,61003,192.168.10.3,53,17,0.000165,4,2,2,344,156,188,18181.818359,CON,0.000165
b8:ac:6f:1d:1f:6c,18:66:da:9b:e3:7d,192.168.10.9,50498,192.168.10.3,53,17,0.000168,4,2,2,414,168,246,17857.142578,CON,0.000168
b8:ac:6f:1d:1f:6c,00:c1:b1:14:eb:31,192.168.10.9,63998,199.233.57.18,80,6,0.237996,3,2,1,1900,859,1041,8.403502,sSE,0.237996
00:c1:b1:14:eb:31,b8:ac:6f:1d:1f:6c,198.54.12.145,80,192.168.10.9,63044,6,0.202954,4,3,1,474,414,60,14.781675,E,0.202954
b8:ac:6f:1d:1f:6c,00:c1:b1:14:eb:31,192.168.10.9,64074,162.208.22.34,80,6,0.039839,3,2,1,192,126,66,50.202065,sSE,0.039839
b8:ac:6f:1d:1f:6c,00:c1:b1:14:eb:31,192.168.10.9,64075,162.208.22.34,80,6,0.038580,3,2,1,192,126,66,51.840332,sSE,0.038580
00:c1:b1:14:eb:31,b8:ac:6f:1d:1f:6c,198.54.12.145,80,192.168.10.9,63038,6,0.202717,4,3,1,452,392,60,14.798956,E,0.202717
b8:ac:6f:1d:1f:6c,00:c1:b1:14:eb:31,192.168.10.9,62708,23.15.4.11,80,6,0.220177,3,2,1,993,618,375,9.083601,E,0.220177
00:c1:b1:14:eb:31,b8:ac:6f:1d:1f:6c,198.54.12.145,80,192.168.10.9,63045,6,0.194346,4,3,1,478,418,60,15.436387,E,0.194346
b8:ac:6f:1d:1f:6c,18:66:da:9b:e3:7d,192.168.10.9,57827,192.168.10.3,53,17,0.031249,4,2,2,734,150,584,96.003075,CON,0.031249
b8:ac:6f:1d:1f:6c,18:66:da:9b:e3:7d,192.168.10.9,53870,192.168.10.3,53,17,0.031327,4,2,2,560,166,394,95.764030,CON,0.031327
18:66:da:9b:e3:7d,00:c1:b1:14:eb:31,192.168.10.3,61170,192.168.10.1,53,17,0.030752,2,1,1,368,120,248,32.518211,CON,0.030752
18:66:da:9b:e3:7d,00:c1:b1:14:eb:31,192.168.10.3,61432,192.168.10.1,53,17,0.030930,2,1,1,214,91,123,32.331070,CON,0.030930
00:c1:b1:14:eb:31,b8:ac:6f:1d:1f:6c,52.3.119.216,80,192.168.10.9,63072,6,0.058470,2,0,2,1349,0,1349,17.102787,E,0.058470
b8:ac:6f:1d:1f:6c,00:c1:b1:14:eb:31,192.168.10.9,62875,172.217.10.130,80,6,0.259326,3,2,1,1457,617,840,7.712300,E,0.259326
b8:ac:6f:1d:1f:6c,18:66:da:9b:e3:7d,192.168.10.9,62479,192.168.10.3,53,17,0.030591,4,2,2,468,150,318,98.068062,CON,0.030591
18:66:da:9b:e3:7d,00:c1:b1:14:eb:31,192.168.10.3,60170,192.168.10.1,53,17,0.030190,2,1,1,202,93,109,33.123550,CON,0.030190
b8:ac:6f:1d:1f:6c,18:66:da:9b:e3:7d,192.168.10.9,54271,192.168.10.3,53,17,0.000235,4,2,2,694,152,542,12765.957031,CON,0.000235
b8:ac:6f:1d:1f:6c,00:c1:b1:14:eb:31,192.168.10.9,64076,54.225.188.92,80,6,2.481412,12,6,6,2096,746,1350,4.432960,sSEfF,2.481412
b8:ac:6f:1d:1f:6c,00:c1:b1:14:eb:31,192.168.10.9,64077,54.225.188.92,80,6,2.482013,7,4,3,432,246,186,2.417393,sSEf,2.482013
b8:ac:6f:1d:1f:6c,18:66:da:9b:e3:7d,192.168.10.9,56467,192.168.10.3,53,17,0.000224,4,2,2,694,152,542,13392.857422,CON,0.000224
b8:ac:6f:1d:1f:6c,18:66:da:9b:e3:7d,192.168.10.9,60720,192.168.10.3,53,17,0.000166,4,2,2,384,160,224,18072.289062,CON,0.000166
b8:ac:6f:1d:1f:6c,18:66:da:9b:e3:7d,192.168.10.9,59961,192.168.10.3,53,17,0.000156,4,2,2,692,218,474,19230.769531,CON,0.000156
b8:ac:6f:1d:1f:6c,18:66:da:9b:e3:7d,192.168.10.9,63733,192.168.10.3,53,17,0.000203,4,2,2,720,232,488,14778.325195,CON,0.000203
b8:ac:6f:1d:1f:6c,18:66:da:9b:e3:7d,192.168.10.9,56720,192.168.10.3,53,17,0.000157,4,2,2,360,164,196,19108.279297,CON,0.000157
b8:ac:6f:1d:1f:6c,00:c1:b1:14:eb:31,192.168.10.9,63882,172.217.7.14,80,6,0.036604,2,1,1,126,60,66,27.319420,sSE,0.036604
b8:ac:6f:1d:1f:6c,18:66:da:9b:e3:7d,192.168.10.9,59384,192.168.10.3,53,17,0.000011,4,2,2,486,152,334,272727.281250,CON,0.000011
b8:ac:6f:1d:1f:6c,18:66:da:9b:e3:7d,192.168.10.9,50571,192.168.10.3,53,17,0.000236,4,2,2,486,152,334,12711.864258,CON,0.000236
b8:ac:6f:1d:1f:6c,18:66:da:9b:e3:7d,192.168.10.9,56624,192.168.10.3,53,17,0.000176,4,2,2,486,152,334,17045.455078,CON,0.000176
b8:ac:6f:1d:1f:6c,00:c1:b1:14:eb:31,192.168.10.9,64078,23.194.108.45,80,6,0.023690,3,2,1,192,126,66,84.423805,sSE,0.023690
b8:ac:6f:1d:1f:6c,18:66:da:9b:e3:7d,192.168.10.9,49948,192.168.10.3,53,17,0.000172,4,2,2,486,152,334,17441.861328,CON,0.000172
b8:ac:6f:1d:1f:6c,18:66:da:9b:e3:7d,192.168.10.9,52533,192.168.10.3,53,17,0.000189,4,2,2,360,164,196,15873.015625,CON,0.000189
b8:ac:6f:1d:1f:6c,18:66:da:9b:e3:7d,192.168.10.9,63891,192.168.10.3,53,17,0.000148,4,2,2,360,164,196,20270.269531,CON,0.000148
b8:ac:6f:1d:1f:6c,18:66:da:9b:e3:7d,192.168.10.9,64415,192.168.10.3,53,17,0.030950,4,2,2,690,164,526,96.930534,CON,0.030950
18:66:da:9b:e3:7d,00:c1:b1:14:eb:31,192.168.10.3,60314,192.168.10.1,53,17,0.030458,2,1,1,354,113,241,32.832096,CON,0.030458
b8:ac:6f:1d:1f:6c,00:c1:b1:14:eb:31,192.168.10.9,62785,52.206.85.2,80,6,0.249237,3,2,1,1542,660,882,8.024490,E,0.249237
b8:ac:6f:1d:1f:6c,18:66:da:9b:e3:7d,192.168.10.9,63214,192.168.10.3,53,17,0.031013,4,2,2,654,146,508,96.733627,CON,0.031013
18:66:da:9b:e3:7d,00:c1:b1:14:eb:31,192.168.10.3,61448,192.168.10.1,53,17,0.030435,2,1,1,354,113,241,32.856907,CON,0.030435
b8:ac:6f:1d:1f:6c,00:c1:b1:14:eb:31,192.168.10.9,64079,107.20.211.51,80,6,0.379847,7,4,3,2180,1425,755,15.795834,sSE,0.379847
b8:ac:6f:1d:1f:6c,18:66:da:9b:e3:7d,192.168.10.9,54604,192.168.10.3,53,17,0.000178,4,2,2,664,204,460,16853.931641,CON,0.000178
b8:ac:6f:1d:1f:6c,00:c1:b1:14:eb:31,192.168.10.9,64080,107.20.211.51,80,6,0.051137,3,2,1,192,126,66,39.110622,sSE,0.051137
b8:ac:6f:1d:1f:6c,18:66:da:9b:e3:7d,192.168.10.9,53973,192.168.10.3,53,17,0.000208,4,2,2,664,204,460,14423.077148,CON,0.000208
b8:ac:6f:1d:1f:6c,00:c1:b1:14:eb:31,192.168.10.9,64081,208.81.233.48,80,6,0.124340,9,5,4,1745,848,897,64.339714,sSEfF,0.124340
b8:ac:6f:1d:1f:6c,00:c1:b1:14:eb:31,192.168.10.9,64082,208.81.233.48,80,6,0.040392,3,2,1,186,126,60,49.514755,sSE,0.040392
b8:ac:6f:36:07:ee,18:66:da:9b:e3:7d,192.168.10.14,53926,192.168.10.3,53,17,0.000172,4,2,2,436,148,288,17441.861328,CON,0.000172
b8:ac:6f:36:07:ee,00:c1:b1:14:eb:31,192.168.10.14,51846,173.194.206.109,465,6,1.851867,44,19,25,8409,2467,5942,23.219810,sSEfFR,1.851867
b8:ac:6f:1d:1f:6c,18:66:da:9b:e3:7d,192.168.10.9,61075,192.168.10.3,53,17,0.000225,4,2,2,694,152,542,13333.333984,CON,0.000225
b8:ac:6f:1d:1f:6c,18:66:da:9b:e3:7d,192.168.10.9,64727,192.168.10.3,53,17,0.000217,4,2,2,694,152,542,13824.884766,CON,0.000217
b8:ac:6f:1d:1f:6c,18:66:da:9b:e3:7d,192.168.10.9,52963,192.168.10.3,53,17,0.000202,4,2,2,720,232,488,14851.485352,CON,0.000202
b8:ac:6f:1d:1f:6c,00:c1:b1:14:eb:31,192.168.10.9,62858,35.167.226.133,80,6,0.291087,3,2,1,1385,640,745,6.870798,E,0.291087
b8:ac:6f:36:04:e3,00:c1:b1:14:eb:31,192.168.10.12,123,152.2.133.52,123,17,0.044930,2,1,1,180,90,90,22.256844,CON,0.044930
b8:ac:6f:1d:1f:6c,18:66:da:9b:e3:7d,192.168.10.9,56383,192.168.10.3,53,17,0.031057,4,2,2,764,148,616,96.596581,CON,0.031057
18:66:da:9b:e3:7d,00:c1:b1:14:eb:31,192.168.10.3,61406,192.168.10.1,53,17,0.030529,2,1,1,370,121,249,32.755741,CON,0.030529
b8:ac:6f:1d:1f:6c,00:c1:b1:14:eb:31,192.168.10.9,64083,8.43.72.47,443,6,0.293016,14,7,7,6163,2210,3953,44.366180,sSE,0.293016
00:c1:b1:14:eb:31,b8:ac:6f:1d:1f:6c,198.54.12.145,443,192.168.10.9,63081,6,0.000000,2,1,1,120,60,60,0.000000,E,0.000000
b8:ac:6f:1d:1f:6c,18:66:da:9b:e3:7d,192.168.10.9,63602,192.168.10.3,53,17,0.000211,4,2,2,696,220,476,14218.008789,CON,0.000211
b8:ac:6f:1d:1f:6c,18:66:da:9b:e3:7d,192.168.10.9,56989,192.168.10.3,53,17,0.000222,4,2,2,694,152,542,13513.513672,CON,0.000222
b8:ac:6f:1d:1f:6c,18:66:da:9b:e3:7d,192.168.10.9,49440,192.168.10.3,53,17,0.000932,4,2,2,694,152,542,3218.884033,CON,0.000932
18:66:da:9b:e3:7d,00:c1:b1:14:eb:31,192.168.10.3,60586,192.168.10.1,53,17,0.000441,2,1,1,382,127,255,2267.573730,CON,0.000441
b8:ac:6f:1d:1f:6c,18:66:da:9b:e3:7d,192.168.10.9,50624,192.168.10.3,53,17,0.000209,4,2,2,720,232,488,14354.066406,CON,0.000209
b8:ac:6f:1d:1f:6c,18:66:da:9b:e3:7d,192.168.10.9,58864,192.168.10.3,53,17,0.030792,4,2,2,454,172,282,97.427902,CON,0.030792
18:66:da:9b:e3:7d,00:c1:b1:14:eb:31,192.168.10.3,60411,192.168.10.1,53,17,0.030458,2,1,1,249,97,152,32.832096,CON,0.030458
b8:ac:6f:1d:1f:6c,18:66:da:9b:e3:7d,192.168.10.9,50889,192.168.10.3,53,17,0.031166,4,2,2,454,172,282,96.258743,CON,0.031166
18:66:da:9b:e3:7d,00:c1:b1:14:eb:31,192.168.10.3,60591,192.168.10.1,53,17,0.030818,2,1,1,249,97,152,32.448570,CON,0.030818
b8:ac:6f:1d:1f:6c,00:c1:b1:14:eb:31,192.168.10.9,63108,129.146.14.101,80,6,0.294690,3,2,1,1112,550,562,6.786793,E,0.294690
b8:ac:6f:36:0a:8b,00:c1:b1:14:eb:31,192.168.10.5,51907,50.19.216.194,443,6,0.050758,2,1,1,120,60,60,19.701328,EfF,0.050758
b8:ac:6f:36:0a:8b,00:c1:b1:14:eb:31,192.168.10.5,52090,54.192.37.143,443,6,0.029742,2,1,1,120,60,60,33.622486,sSEfF,0.029742
b8:ac:6f:36:0a:8b,18:66:da:9b:e3:7d,192.168.10.5,60706,192.168.10.3,53,17,0.000188,4,2,2,568,156,412,15957.446289,CON,0.000188
b8:ac:6f:36:0a:8b,00:c1:b1:14:eb:31,192.168.10.5,52141,23.21.240.128,443,6,0.241110,13,7,6,4972,1457,3515,49.769814,sSE,0.241110
b8:ac:6f:36:0a:8b,00:c1:b1:14:eb:31,192.168.10.5,52122,184.72.116.124,443,6,0.050462,2,1,1,126,60,66,19.816893,sSE,0.050462
00:23:ae:9b:95:67,00:c1:b1:14:eb:31,192.168.10.17,123,173.255.246.13,123,17,0.084452,2,1,1,180,90,90,11.841045,CON,0.084452
b8:ac:6f:1d:1f:6c,18:66:da:9b:e3:7d,192.168.10.9,53842,192.168.10.3,53,17,0.000210,4,2,2,694,152,542,14285.714844,CON,0.000210
b8:ac:6f:1d:1f:6c,18:66:da:9b:e3:7d,192.168.10.9,62054,192.168.10.3,53,17,0.000215,4,2,2,694,152,542,13953.489258,CON,0.000215
b8:ac:6f:1d:1f:6c,18:66:da:9b:e3:7d,192.168.10.9,64838,192.168.10.3,53,17,0.000202,4,2,2,720,232,488,14851.485352,CON,0.000202
b8:ac:6f:36:0a:8b,00:c1:b1:14:eb:31,192.168.10.5,52127,184.72.116.124,443,6,0.050465,2,1,1,126,60,66,19.815714,sSE,0.050465
b8:ac:6f:1d:1f:6c,00:c1:b1:14:eb:31,192.168.10.9,63982,72.21.81.64,80,6,0.023880,2,1,1,126,60,66,41.876049,sSE,0.023880
b8:ac:6f:1d:1f:6c,00:c1:b1:14:eb:31,192.168.10.9,63886,172.217.10.226,80,6,0.037117,2,1,1,126,60,66,26.941832,sSE,0.037117
b8:ac:6f:1d:1f:6c,00:c1:b1:14:eb:31,192.168.10.9,63040,198.54.12.145,80,6,0.000000,3,1,2,180,60,120,0.000000,E,0.000000
b8:ac:6f:1d:1f:6c,18:66:da:9b:e3:7d,192.168.10.9,61421,192.168.10.3,53,17,0.001002,4,2,2,486,152,334,2994.012207,CON,0.001002
18:66:da:9b:e3:7d,00:c1:b1:14:eb:31,192.168.10.3,60184,192.168.10.1,53,17,0.000550,2,1,1,202,93,109,1818.181885,CON,0.000550
b8:ac:6f:1d:1f:6c,18:66:da:9b:e3:7d,192.168.10.9,55055,192.168.10.3,53,17,0.000154,4,2,2,360,164,196,19480.519531,CON,0.000154
b8:ac:6f:1d:1f:6c,00:c1:b1:14:eb:31,192.168.10.9,64002,173.241.242.220,80,6,0.377409,4,2,2,1947,875,1072,7.948936,sSE,0.377409
b8:ac:6f:1d:1f:6c,00:c1:b1:14:eb:31,192.168.10.9,64016,52.9.83.130,80,6,0.087741,2,1,1,126,60,66,11.397180,sSE,0.087741
b8:ac:6f:1d:1f:6c,00:c1:b1:14:eb:31,192.168.10.9,63213,23.194.108.16,443,6,0.023706,2,1,1,126,60,66,42.183414,E,0.023706
00:1e:4f:d4:ca:28,00:c1:b1:14:eb:31,192.168.10.15,50483,64.4.54.254,443,6,0.149442,5,3,2,2585,2130,455,26.766237,sSE,0.149442
b8:ac:6f:36:0b:a8,18:66:da:9b:e3:7d,192.168.10.51,13981,192.168.10.3,53,17,0.000055,4,2,2,368,152,216,54545.453125,CON,0.000055
00:1e:4f:d4:ca:28,00:c1:b1:14:eb:31,192.168.10.15,50482,192.35.249.123,443,6,1.071524,7,3,4,4092,1603,2489,5.599501,sSE,1.071524
00:23:ae:9b:8a:bf,00:c1:b1:14:eb:31,192.168.10.16,47284,104.88.32.234,443,6,0.023190,2,1,1,132,66,66,43.122036,sSE,0.023190
b8:ac:6f:1d:1f:6c,00:c1:b1:14:eb:31,192.168.10.9,64018,52.9.151.139,80,6,0.087125,2,1,1,126,60,66,11.477761,sSE,0.087125
00:23:ae:9b:ad:b3,00:c1:b1:14:eb:31,192.168.10.19,44161,151.101.0.67,443,6,0.015192,6,4,2,446,283,163,329.120575,sSEfFR,0.015192
00:23:ae:9b:ad:b3,00:c1:b1:14:eb:31,192.168.10.19,44162,151.101.0.67,443,6,0.015379,6,4,2,446,283,163,325.118652,sSEfFR,0.015379
00:23:ae:9b:ad:b3,00:c1:b1:14:eb:31,192.168.10.19,44163,151.101.0.67,443,6,0.015339,6,4,2,446,283,163,325.966492,sSEfFR,0.015339
00:23:ae:9b:8a:bf,00:c1:b1:14:eb:31,192.168.10.16,49674,192.243.250.36,443,6,0.040770,5,3,2,347,227,120,98.111351,sSEfF,0.040770
00:23:ae:9b:8a:bf,00:c1:b1:14:eb:31,192.168.10.16,59540,192.243.232.58,443,6,0.102090,5,3,2,347,227,120,39.181114,sSEfF,0.102090
00:23:ae:9b:8a:bf,00:c1:b1:14:eb:31,192.168.10.16,49646,192.243.250.36,443,6,0.034698,5,3,2,347,227,120,115.280426,sSEfF,0.034698
00:23:ae:9b:8a:bf,00:c1:b1:14:eb:31,192.168.10.16,49654,192.243.250.36,443,6,0.041175,5,3,2,347,227,120,97.146324,sSEfF,0.041175
00:23:ae:9b:8a:bf,00:c1:b1:14:eb:31,192.168.10.16,49656,192.243.250.36,443,6,0.039877,5,3,2,347,227,120,100.308449,sSEfF,0.039877
00:23:ae:9b:8a:bf,00:c1:b1:14:eb:31,192.168.10.16,49648,192.243.250.36,443,6,0.041004,5,3,2,347,227,120,97.551460,sSEfF,0.041004
00:23:ae:9b:8a:bf,00:c1:b1:14:eb:31,192.168.10.16,49652,192.243.250.36,443,6,0.040817,5,3,2,347,227,120,97.998383,sSEfF,0.040817
b8:ac:6f:36:08:f5,00:c1:b1:14:eb:31,192.168.10.8,49425,52.39.237.157,443,6,0.085157,2,1,1,120,60,60,11.743016,sSE,0.085157
b8:ac:6f:1d:1f:6c,00:c1:b1:14:eb:31,192.168.10.9,63899,69.169.86.38,443,6,0.022733,2,1,1,120,60,60,43.988914,sSE,0.022733
00:23:ae:9b:8a:bf,00:c1:b1:14:eb:31,192.168.10.16,56736,52.84.30.244,443,6,0.031237,2,1,1,132,66,66,32.013317,sSE,0.031237
b8:ac:6f:36:08:f5,00:c1:b1:14:eb:31,192.168.10.8,49434,54.192.39.67,80,6,0.029737,2,1,1,126,60,66,33.628139,sSE,0.029737
b8:ac:6f:1d:1f:6c,00:c1:b1:14:eb:31,192.168.10.9,63119,74.121.138.156,443,6,0.024069,2,1,1,126,60,66,41.547218,E,0.024069
b8:ac:6f:36:08:f5,00:c1:b1:14:eb:31,192.168.10.8,49418,35.160.100.86,443,6,0.084696,2,1,1,126,60,66,11.806932,sSE,0.084696
00:23:ae:9b:8a:bf,00:c1:b1:14:eb:31,192.168.10.16,37508,54.192.37.225,443,6,0.030852,2,1,1,132,66,66,32.412811,sSE,0.030852
b8:ac:6f:36:0a:8b,00:c1:b1:14:eb:31,192.168.10.5,52081,104.97.122.33,443,6,0.023328,2,1,1,126,60,66,42.866940,sSE,0.023328
00:23:ae:9b:8a:bf,00:c1:b1:14:eb:31,192.168.10.16,48804,23.194.108.111,443,6,0.023638,2,1,1,132,66,66,42.304764,sSE,0.023638
b8:ac:6f:1d:1f:6c,00:c1:b1:14:eb:31,192.168.10.9,63904,152.163.56.2,443,6,0.028182,2,1,1,120,60,60,35.483643,sSE,0.028182
b8:ac:6f:36:08:f5,00:c1:b1:14:eb:31,192.168.10.8,49437,23.203.74.20,80,6,0.023088,2,1,1,126,60,66,43.312542,sSE,0.023088
b8:ac:6f:36:08:f5,00:c1:b1:14:eb:31,192.168.10.8,49430,172.217.10.142,80,6,0.036507,2,1,1,126,60,66,27.392008,sSE,0.036507
b8:ac:6f:36:08:f5,00:c1:b1:14:eb:31,192.168.10.8,49439,23.203.74.20,80,6,0.023102,2,1,1,126,60,66,43.286293,sSE,0.023102
b8:ac:6f:1d:1f:6c,00:c1:b1:14:eb:31,192.168.10.9,63616,184.31.6.135,443,6,0.028704,2,1,1,126,60,66,34.838348,E,0.028704
b8:ac:6f:36:0a:8b,18:66:da:9b:e3:7d,192.168.10.5,50945,192.168.10.3,53,17,0.031793,4,2,2,454,172,282,94.360397,CON,0.031793
18:66:da:9b:e3:7d,00:c1:b1:14:eb:31,192.168.10.3,61130,192.168.10.1,53,17,0.031486,2,1,1,249,97,152,31.760147,CON,0.031486
b8:ac:6f:36:0a:8b,00:c1:b1:14:eb:31,192.168.10.5,52088,146.20.129.51,443,6,0.028806,2,1,1,120,60,60,34.714993,sSE,0.028806
00:23:ae:9b:8a:bf,00:c1:b1:14:eb:31,192.168.10.16,37528,54.192.37.225,443,6,0.031178,2,1,1,132,66,66,32.073898,sSE,0.031178
00:23:ae:9b:8a:bf,00:c1:b1:14:eb:31,192.168.10.16,60516,96.16.195.81,443,6,0.023732,2,1,1,132,66,66,42.137199,sSE,0.023732
00:23:ae:9b:8a:bf,00:c1:b1:14:eb:31,192.168.10.16,59606,192.243.232.58,443,6,0.101973,5,3,2,347,227,120,39.226070,sSEfF,0.101973
b8:ac:6f:36:08:f5,00:c1:b1:14:eb:31,192.168.10.8,49442,23.203.74.20,80,6,0.023312,2,1,1,126,60,66,42.896362,sSE,0.023312
b8:ac:6f:1d:1f:6c,00:c1:b1:14:eb:31,192.168.10.9,63911,52.22.157.218,443,6,0.052848,4,2,2,265,120,145,56.766575,sSEfF,0.052848
00:23:ae:9b:ad:b3,18:66:da:9b:e3:7d,192.168.10.19,16072,192.168.10.3,53,17,5.003843,4,4,0,276,276,0,0.599539,INT,5.003843
00:23:ae:9b:ad:b3,18:66:da:9b:e3:7d,192.168.10.19,63286,192.168.10.3,53,17,5.003839,4,4,0,276,276,0,0.599540,INT,5.003839
00:23:ae:9b:8a:bf,00:c1:b1:14:eb:31,192.168.10.16,42944,50.17.246.138,443,6,0.050390,2,1,1,132,66,66,19.845207,sSE,0.050390
b8:ac:6f:1d:1f:6c,00:c1:b1:14:eb:31,192.168.10.9,63912,199.38.164.157,443,6,0.023220,2,1,1,120,60,60,43.066322,sSE,0.023220
b8:ac:6f:36:08:f5,00:c1:b1:14:eb:31,192.168.10.8,49419,72.21.91.29,80,6,0.023900,2,1,1,126,60,66,41.841003,sSE,0.023900
b8:ac:6f:36:0a:8b,00:c1:b1:14:eb:31,192.168.10.5,52125,151.101.0.166,443,6,0.015210,2,1,1,126,60,66,65.746223,sSE,0.015210
b8:ac:6f:36:0a:8b,00:c1:b1:14:eb:31,192.168.10.5,52086,52.204.155.195,443,6,0.050734,2,1,1,126,60,66,19.710648,sSE,0.050734
b8:ac:6f:36:0a:8b,00:c1:b1:14:eb:31,192.168.10.5,51860,169.54.182.108,443,6,0.051862,2,1,1,126,60,66,19.281940,E,0.051862
b8:ac:6f:1d:1f:6c,00:c1:b1:14:eb:31,192.168.10.9,63948,172.217.10.226,80,6,0.037431,2,1,1,126,60,66,26.715822,sSE,0.037431
b8:ac:6f:36:0a:8b,00:c1:b1:14:eb:31,192.168.10.5,52132,146.20.128.61,443,6,0.028497,2,1,1,120,60,60,35.091415,sSE,0.028497
00:23:ae:9b:8a:bf,00:c1:b1:14:eb:31,192.168.10.16,36558,52.205.102.17,443,6,0.050386,2,1,1,132,66,66,19.846783,sSE,0.050386
00:23:ae:9b:8a:bf,00:c1:b1:14:eb:31,192.168.10.16,46166,72.247.66.125,443,6,0.023470,2,1,1,132,66,66,42.607586,sSE,0.023470
b8:ac:6f:36:0a:8b,00:c1:b1:14:eb:31,192.168.10.5,52096,46.105.203.17,443,6,0.016434,2,1,1,126,60,66,60.849457,sSE,0.016434
00:23:ae:9b:8a:bf,00:c1:b1:14:eb:31,192.168.10.16,36074,72.30.3.43,443,6,0.024533,4,1,3,295,66,229,122.284271,sSEfF,0.024533
00:23:ae:9b:8a:bf,00:c1:b1:14:eb:31,192.168.10.16,45402,98.139.225.43,443,6,0.025215,5,2,3,361,132,229,158.635727,sSEfF,0.025215
